//MAP CONVERTED BY dmm2tgm.py THIS HEADER COMMENT PREVENTS RECONVERSION, DO NOT REMOVE
"aa" = (
/turf/template_noop,
/area/tether_away/debrisfield/explored)
"ab" = (
/turf/wall/thull,
/area/tether_away/debrisfield/explored)
"ac" = (
/turf/floor/airless,
/area/tether_away/debrisfield/explored)
"ad" = (
/turf/floor/tiled/white/airless,
/area/tether_away/debrisfield/explored)
"ae" = (
/obj/machinery/portable_atmospherics/hydroponics,
/turf/floor/tiled/white/airless,
/area/tether_away/debrisfield/explored)
"af" = (
/obj/machinery/botany/editor,
/turf/floor/tiled/white/airless,
/area/tether_away/debrisfield/explored)
"ag" = (
/obj/machinery/vending/hydronutrients,
/turf/floor/tiled/white/airless,
/area/tether_away/debrisfield/explored)
"ah" = (
/obj/machinery/seed_extractor,
/turf/floor/tiled/white/airless,
/area/tether_away/debrisfield/explored)
"ai" = (
/obj/machinery/seed_storage/xenobotany,
/turf/floor/tiled/white/airless,
/area/tether_away/debrisfield/explored)
"aj" = (
/obj/machinery/botany/extractor,
/turf/floor/tiled/white/airless,
/area/tether_away/debrisfield/explored)
"ak" = (
/obj/item/seeds/killertomatoseed,
/turf/floor/tiled/white/airless,
/area/tether_away/debrisfield/explored)
"al" = (
/obj/structure/railing,
/turf/floor/tiled/white/airless,
/area/tether_away/debrisfield/explored)
"am" = (
/obj/structure/railing{
	dir = 4
	},
/turf/floor/tiled/white/airless,
/area/tether_away/debrisfield/explored)
"an" = (
/obj/structure/reagent_dispensers/watertank/high,
/turf/floor/tiled/white/airless,
/area/tether_away/debrisfield/explored)
"ao" = (
/obj/structure/railing{
	dir = 8
	},
/turf/floor/tiled/white/airless,
/area/tether_away/debrisfield/explored)
"ap" = (
/obj/structure/rack,
/obj/item/tool/spade,
/obj/item/tool/spade,
/obj/item/minihoe,
/obj/item/minihoe,
/obj/item/knife/machete/hatchet,
/obj/item/knife/machete/hatchet,
/obj/item/chems/glass/bucket,
/obj/item/chems/glass/bucket,
/obj/item/scanner/plant,
/obj/item/scanner/plant,
/turf/floor/tiled/white/airless,
/area/tether_away/debrisfield/explored)
"aq" = (
/obj/structure/railing{
	dir = 1
	},
/turf/floor/tiled/white/airless,
/area/tether_away/debrisfield/explored)
"ar" = (
/mob/living/simple_mob/tomato/space,
/turf/floor/tiled/white/airless,
/area/tether_away/debrisfield/explored)
"as" = (
/obj/structure/rack,
/obj/random/tool,
/obj/random/tool,
/obj/random/tool,
/turf/floor/airless,
/area/tether_away/debrisfield/explored)
"at" = (
/obj/machinery/door/airlock/science,
/turf/floor/tiled/white/airless,
/area/tether_away/debrisfield/explored)
"au" = (
/obj/item/clothing/head/collectable/slime,
/turf/floor/tiled/white/airless,
/area/tether_away/debrisfield/explored)
"av" = (
/obj/structure/sign/hydro,
/turf/wall/thull,
/area/tether_away/debrisfield/explored)
"aw" = (
/obj/structure/closet/firecloset,
/turf/floor/tiled/white/airless,
/area/tether_away/debrisfield/explored)
"ax" = (
/obj/machinery/door/airlock/maintenance{
	name = "Research Airlock"
	},
/turf/floor/airless,
/area/tether_away/debrisfield/explored)
"ay" = (
/obj/structure/sign/department/xenobio_3,
/turf/wall/thull,
/area/tether_away/debrisfield/explored)
"az" = (
/obj/item/scanner/xenobio,
/obj/item/scanner/xenobio,
/obj/structure/table/reinforced,
/turf/floor/tiled/white/airless,
/area/tether_away/debrisfield/explored)
"aA" = (
/obj/structure/table/reinforced,
/obj/item/gun/energy/taser/xeno,
/obj/item/baton/slime/loaded,
/turf/floor/tiled/white/airless,
/area/tether_away/debrisfield/explored)
"aB" = (
/obj/structure/table/reinforced,
/turf/floor/tiled/white/airless,
/area/tether_away/debrisfield/explored)
"aC" = (
/obj/structure/table/reinforced,
/obj/item/food/monkeycube,
/obj/item/food/monkeycube/farwacube,
/obj/item/food/monkeycube/neaeracube,
/obj/item/food/monkeycube/sarucube,
/obj/item/food/monkeycube/sobakacube,
/obj/item/food/monkeycube/sparracube,
/obj/item/food/monkeycube/stokcube,
/obj/item/food/monkeycube/wolpincube,
/turf/floor/tiled/white/airless,
/area/tether_away/debrisfield/explored)
"aD" = (
/obj/machinery/optable,
/obj/item/slime_extract/dark_blue,
/turf/floor/tiled/white/airless,
/area/tether_away/debrisfield/explored)
"aE" = (
/obj/structure/grille,
/obj/structure/window/reinforced/full,
/turf/floor/airless,
/area/tether_away/debrisfield/explored)
"aF" = (
/obj/item/chems/spray/plantbgone,
/turf/floor/tiled/white/airless,
/area/tether_away/debrisfield/explored)
"aG" = (
/obj/item/chems/spray/chemsprayer,
/turf/floor/tiled/white/airless,
/area/tether_away/debrisfield/explored)
"aH" = (
/obj/tether_away_spawner/debrisfield/carp,
/turf/template_noop,
/area/tether_away/debrisfield/explored)
"aI" = (
/obj/item/remains,
/obj/item/clothing/under/hydroponics,
/obj/item/clothing/suit/toggle/labcoat/green,
/obj/item/clothing/head/bandana/green,
/turf/floor/tiled/white/airless,
/area/tether_away/debrisfield/explored)
"aJ" = (
/obj/structure/rack,
/obj/item/slime_extract/rainbow,
/obj/structure/window/reinforced{
	dir = 4
	},
/obj/structure/window/reinforced{
	dir = 8
	},
/obj/structure/window/reinforced,
/turf/floor/tiled/white/airless,
/area/tether_away/debrisfield/explored)
"aK" = (
/obj/item/gun/energy/temperature,
/obj/structure/rack,
/obj/structure/window/reinforced,
/obj/structure/window/reinforced{
	dir = 1
	},
/obj/structure/window/reinforced{
	dir = 4
	},
/turf/floor/tiled/white/airless,
/area/tether_away/debrisfield/explored)
"aL" = (
/obj/structure/window/reinforced/full,
/obj/structure/grille,
/turf/floor/airless,
/area/tether_away/debrisfield/explored)
"aM" = (
/obj/machinery/computer/shuttle{
	dir = 8
	},
/turf/floor/tiled/white/airless,
/area/tether_away/debrisfield/explored)
"aN" = (
/obj/structure/bed/chair/comfy/purple{
	dir = 4
	},
/turf/floor/tiled/white/airless,
/area/tether_away/debrisfield/explored)
"aO" = (
/obj/item/gun/energy/decloner,
/obj/structure/rack,
/obj/structure/window/reinforced,
/obj/structure/window/reinforced{
	dir = 1
	},
/obj/structure/window/reinforced{
	dir = 4
	},
/turf/floor/tiled/white/airless,
/area/tether_away/debrisfield/explored)
"aP" = (
/obj/structure/filing_cabinet/tall,
/turf/floor/tiled/white/airless,
/area/tether_away/debrisfield/explored)
"aQ" = (
/obj/structure/table/reinforced,
/obj/item/stack/material/crystal/mapped/phoron{
	amount = 10
	},
/obj/item/flashlight/pen,
/turf/floor/tiled/white/airless,
/area/tether_away/debrisfield/explored)
"aR" = (
/obj/structure/table/reinforced,
/obj/item/paper_bin,
/obj/item/pen/blue,
/turf/floor/tiled/white/airless,
/area/tether_away/debrisfield/explored)
"aS" = (
/obj/structure/table/reinforced,
/obj/item/folder,
/turf/floor/tiled/white/airless,
/area/tether_away/debrisfield/explored)
"aT" = (
/mob/living/simple_mob/slime/feral/dark_blue,
/turf/floor/tiled/white/airless,
/area/tether_away/debrisfield/explored)
"aU" = (
/obj/structure/rack,
/obj/structure/window/reinforced{
	dir = 4
	},
/obj/structure/window/reinforced{
	dir = 8
	},
/obj/item/shard,
/obj/item/clothing/mask/breath,
/turf/floor/tiled/white/airless,
/area/tether_away/debrisfield/explored)
"aV" = (
/obj/structure/bed/chair/office/light{
	dir = 1
	},
/turf/floor/tiled/white/airless,
/area/tether_away/debrisfield/explored)
"aW" = (
/obj/item/stock_parts/circuitboard/airlock_electronics,
/turf/floor/tiled/white/airless,
/area/tether_away/debrisfield/explored)
"aX" = (
/obj/item/shard,
/turf/floor/tiled/white/airless,
/area/tether_away/debrisfield/explored)
"aY" = (
/obj/structure/closet/emcloset,
/turf/floor/tiled/white/airless,
/area/tether_away/debrisfield/explored)
"aZ" = (
/obj/structure/door/shuttle,
/turf/floor/tiled/white/airless,
/area/tether_away/debrisfield/explored)
"ba" = (
/obj/item/clothing/suit/toggle/labcoat/purple,
/turf/floor/tiled/white/airless,
/area/tether_away/debrisfield/explored)
"bb" = (
/obj/item/remains,
/obj/item/clothing/under/scientist,
/obj/item/clothing/suit/toggle/labcoat/blue,
/turf/floor/tiled/white/airless,
/area/tether_away/debrisfield/explored)
"bc" = (
/obj/structure/closet/secure_closet/scientist{
	name = "scientist locker"
	},
/turf/floor/tiled/white/airless,
/area/tether_away/debrisfield/explored)
"bd" = (
/obj/structure/bed,
/obj/item/bedsheet/blue,
/turf/floor/tiled/white/airless,
/area/tether_away/debrisfield/explored)
"be" = (
/obj/structure/bed,
/obj/item/bedsheet/green,
/turf/floor/tiled/white/airless,
/area/tether_away/debrisfield/explored)
"bf" = (
/obj/structure/bed,
/obj/item/bedsheet/rd,
/turf/floor/tiled/white/airless,
/area/tether_away/debrisfield/explored)
"bg" = (
/obj/structure/hygiene/sink{
	dir = 8;
	pixel_x = -12
	},
/turf/floor/tiled/white/airless,
/area/tether_away/debrisfield/explored)
"bh" = (
/obj/structure/shuttle/engine/propulsion{
	dir = 8
	},
/turf/floor/airless,
/area/tether_away/debrisfield/explored)
"bi" = (
/obj/structure/rack,
/obj/random/firstaid,
/obj/random/firstaid,
/turf/floor/airless,
/area/tether_away/debrisfield/explored)
"bj" = (
/obj/structure/rack,
/obj/random/unidentified_medicine/scientific,
/obj/random/unidentified_medicine/scientific,
/obj/random/unidentified_medicine/scientific,
/obj/random/unidentified_medicine/scientific,
/turf/floor/airless,
/area/tether_away/debrisfield/explored)
"bk" = (
/obj/machinery/door/airlock/command{
	name = "Research Airlock"
	},
/turf/floor/tiled/white/airless,
/area/tether_away/debrisfield/explored)
"bl" = (
/obj/structure/closet/crate,
/obj/item/stack/material/uranium{
	amount = 11
	},
/turf/floor/airless,
/area/tether_away/debrisfield/explored)
"bm" = (
/obj/structure/closet/crate,
/turf/floor/airless,
/area/tether_away/debrisfield/explored)
"bn" = (
/obj/machinery/port_gen/pacman/super,
/turf/floor/airless,
/area/tether_away/debrisfield/explored)
"bo" = (
/obj/structure/table/reinforced,
/obj/item/slime_extract/random,
/obj/item/slime_extract/random,
/obj/item/slime_extract/random,
/obj/item/slime_extract/random,
/obj/item/slime_extract/random,
/turf/floor/tiled/white/airless,
/area/tether_away/debrisfield/explored)
"bp" = (
/obj/item/prybar/red,
/turf/floor/airless,
/area/tether_away/debrisfield/explored)
"bq" = (
/mob/living/simple_mob/slime/feral/dark_blue,
/turf/floor/airless,
/area/tether_away/debrisfield/explored)

(1,1,1) = {"
aa
aa
aa
aa
aa
aa
aa
aa
aa
aa
aa
aa
aa
aa
aa
aa
aa
aa
aa
aa
aa
aa
aa
aa
aa
"}
(2,1,1) = {"
aa
aa
aa
aa
aa
aa
aa
aa
aa
aa
aa
aa
aa
aa
aa
aa
aa
aa
aa
aa
aa
aa
aa
aa
aa
"}
(3,1,1) = {"
aa
aa
aa
aa
aa
aa
aa
aa
aa
aa
aa
aa
aa
aa
aa
aa
aa
aa
aa
aa
aa
aa
aa
aa
aa
"}
(4,1,1) = {"
aa
aa
aa
ab
bh
bh
ab
ab
bh
bh
ab
aa
aa
aa
ab
bh
bh
ab
ab
bh
bh
ab
aa
aa
aa
"}
(5,1,1) = {"
aa
aa
aa
ab
ab
ab
ab
ab
ab
ab
ab
bp
ac
ac
ab
ab
ab
ab
ab
ab
ab
ab
aa
aa
aa
"}
(6,1,1) = {"
aa
aa
aa
ab
as
as
ac
ac
bi
bj
ab
ab
aZ
ab
ab
bl
ac
ac
ac
ac
bm
ab
aa
aa
aa
"}
(7,1,1) = {"
aa
aa
aa
ab
ac
ac
ac
ac
bq
ac
ab
aY
ad
aY
ab
bm
ac
ac
ac
ac
bn
ab
aa
aa
aa
"}
(8,1,1) = {"
aa
aa
aa
ab
ab
ab
ax
ab
ab
ab
ab
ab
aZ
ab
ab
ab
ab
ab
ax
ab
ab
ab
aa
aa
aa
"}
(9,1,1) = {"
aa
aa
aa
ab
ad
ad
ad
ad
ad
ad
ad
ad
ad
ad
ad
ad
ad
ad
ad
ad
ad
ab
aa
aa
aa
"}
(10,1,1) = {"
aa
aa
aa
ab
ad
ad
ad
ad
ad
ad
ad
ad
ad
ad
ad
ad
ad
ad
ad
ad
ad
ab
aa
aa
aa
"}
(11,1,1) = {"
aa
aa
aa
ab
ab
ab
ab
ab
at
ab
ab
ad
ad
ad
ab
ab
ab
ab
ab
ab
ab
ab
aa
aa
aa
"}
(12,1,1) = {"
aa
aa
aa
ab
bc
bc
bc
ad
ad
bg
ab
ad
ad
ad
ab
aP
ad
ad
ab
ad
ad
ab
aa
aa
aa
"}
(13,1,1) = {"
aa
aa
aa
aE
ad
ad
ad
ad
au
ad
ab
ad
ad
ad
ab
aQ
ad
aW
aX
ad
ad
ab
aa
aa
aa
"}
(14,1,1) = {"
aa
aa
aa
aE
ad
ad
ad
ad
ad
ad
ab
ad
ad
ad
ab
aR
aV
ad
ab
ab
ab
ab
aa
aa
aa
"}
(15,1,1) = {"
aa
aa
aa
ab
bd
ad
be
ad
ad
bf
ab
ad
ad
ad
ab
aS
ad
ad
ab
ad
ad
ab
aa
aa
aa
"}
(16,1,1) = {"
aa
aa
aa
ab
ab
ab
ab
ab
ab
ab
ab
ad
ad
ad
ab
aB
ad
aT
aX
ad
ad
ab
aa
aa
aa
"}
(17,1,1) = {"
aa
aa
aa
ab
ae
ae
ae
ae
ae
ae
ab
ad
ad
ad
ab
ad
ad
ad
ab
ab
ab
ab
aa
aa
aa
"}
(18,1,1) = {"
aa
aa
aa
ab
ad
ak
ad
ad
ar
ad
ab
ad
ad
ad
ab
ad
ad
aX
ab
ad
ad
ab
aa
aa
aa
"}
(19,1,1) = {"
aa
aa
aa
ab
af
ar
ad
ad
ad
ad
ab
ad
ad
ad
ab
ad
ad
aW
ad
ad
ad
ab
aa
aa
aa
"}
(20,1,1) = {"
aa
aa
aa
ab
ag
ad
am
am
ad
ar
av
ad
ad
ad
ab
ad
ad
ad
ab
ab
ab
ab
aa
aa
aa
"}
(21,1,1) = {"
aa
aa
aa
ab
ah
al
an
ap
aq
ad
at
ad
ad
ad
ab
ad
ad
ad
aw
aw
aw
ab
aa
aa
aa
"}
(22,1,1) = {"
aa
aa
aa
ab
ai
ad
ao
ao
ad
ad
ab
ad
ad
ad
ay
ad
bb
ad
ad
ad
ad
ab
aa
aa
aa
"}
(23,1,1) = {"
aa
aa
aa
ab
aj
aF
ar
ad
ad
ad
ab
ad
ad
ad
at
ad
ad
ad
ad
ad
ad
ab
aa
aa
aa
"}
(24,1,1) = {"
aa
aa
aa
ab
aF
aG
aI
ad
ar
ak
ab
ad
ad
ad
ab
ad
ad
ad
ad
ad
ad
ab
aa
aa
aa
"}
(25,1,1) = {"
aa
aa
aa
ab
ae
ae
ae
ae
ae
ae
ab
aw
ad
aw
ab
az
aA
bo
bo
aC
aD
ab
aa
aa
aa
"}
(26,1,1) = {"
aa
aa
aa
ab
ab
ab
ab
ab
ab
ab
ab
ab
bk
ab
ab
ab
ab
ab
ab
ab
ab
ab
aa
aa
aa
"}
(27,1,1) = {"
aa
aa
aa
aa
aa
aa
aa
aa
ab
ad
aK
ad
ad
ad
aO
ad
ab
aa
aa
aa
aa
aa
aa
aa
aa
"}
(28,1,1) = {"
aa
aa
aa
aa
aa
aa
aa
aa
aE
ad
ad
ad
ad
ad
ad
ad
aE
aa
aa
aa
aa
aa
aa
aa
aa
"}
(29,1,1) = {"
aa
aa
aa
aa
aa
aa
aa
aa
aE
aJ
ad
ad
aN
ad
ba
aU
aE
aa
aa
aa
aa
aa
aa
aa
aa
"}
(30,1,1) = {"
aa
aa
aa
aa
aa
aH
aa
aa
ab
ad
ad
aM
aM
aM
ad
ad
ab
aa
aa
aa
aa
aa
aa
aa
aa
"}
(31,1,1) = {"
aa
aa
aa
aa
aa
aa
aa
aa
ab
ab
aL
aE
aE
aE
aE
ab
ab
aa
aa
aa
aa
aa
aa
aa
aa
"}
(32,1,1) = {"
aa
aa
aa
aa
aa
aa
aa
aa
aa
aa
aa
aa
aa
aa
aa
aa
aa
aa
aa
aa
aa
aa
aa
aa
aa
"}
