//MAP CONVERTED BY dmm2tgm.py THIS HEADER COMMENT PREVENTS RECONVERSION, DO NOT REMOVE
"a" = (
/turf/template_noop,
/area/tether_away/debrisfield/explored)
"b" = (
/turf/wall/natural,
/area/tether_away/debrisfield/explored)
"c" = (
/turf/wall/shuttle,
/area/tether_away/debrisfield/explored)
"d" = (
/turf/exterior/barren,
/area/tether_away/debrisfield/explored)
"e" = (
/obj/structure/shuttle/window,
/obj/structure/grille,
/turf/floor/airless,
/area/tether_away/debrisfield/explored)
"f" = (
/turf/floor/shuttle/blue/airless,
/area/tether_away/debrisfield/explored)
"g" = (
/obj/effect/decal/cleanable/generic,
/turf/exterior/barren,
/area/tether_away/debrisfield/explored)
"h" = (
/obj/effect/decal/cleanable/dirt,
/obj/machinery/constructable_frame/machine_frame,
/turf/floor/airless,
/area/tether_away/debrisfield/explored)
"i" = (
/obj/machinery/constructable_frame/machine_frame,
/turf/floor/shuttle/blue/airless,
/area/tether_away/debrisfield/explored)
"j" = (
/obj/structure/closet/secure_closet/sar{
	name = "sar locker"
	},
/turf/floor/shuttle/blue/airless,
/area/tether_away/debrisfield/explored)
"k" = (
/obj/structure/shuttle/engine/propulsion{
	dir = 4
	},
/turf/floor/airless,
/area/tether_away/debrisfield/explored)
"l" = (
/obj/effect/decal/cleanable/dirt,
/turf/floor/airless,
/area/tether_away/debrisfield/explored)
"m" = (
/obj/structure/table,
/obj/random/unidentified_medicine/fresh_medicine,
/obj/random/unidentified_medicine/fresh_medicine,
/obj/random/unidentified_medicine/old_medicine,
/turf/floor/shuttle/blue/airless,
/area/tether_away/debrisfield/explored)
"n" = (
/obj/effect/decal/cleanable/dirt,
/obj/effect/decal/cleanable/generic,
/turf/floor/airless,
/area/tether_away/debrisfield/explored)
"o" = (
/obj/structure/table,
/obj/random/unidentified_medicine/fresh_medicine,
/obj/random/unidentified_medicine/fresh_medicine,
/obj/random/unidentified_medicine/viral,
/turf/floor/shuttle/blue/airless,
/area/tether_away/debrisfield/explored)
"p" = (
/obj/structure/closet/secure_closet/medical3{
	name = "medical locker"
	},
/turf/floor/shuttle/blue/airless,
/area/tether_away/debrisfield/explored)
"q" = (
/obj/effect/decal/cleanable/dirt,
/obj/effect/decal/cleanable/molten_item,
/turf/floor/airless,
/area/tether_away/debrisfield/explored)
"r" = (
/obj/effect/decal/cleanable/dirt,
/obj/effect/decal/cleanable/blood/oil,
/turf/floor/airless,
/area/tether_away/debrisfield/explored)
"s" = (
/obj/effect/decal/cleanable/dirt,
/obj/item/remains/posi,
/turf/floor/airless,
/area/tether_away/debrisfield/explored)
"t" = (
/obj/structure/door/shuttle,
/turf/floor/shuttle/blue/airless,
/area/tether_away/debrisfield/explored)
"u" = (
/obj/structure/closet/emcloset,
/turf/floor/shuttle/blue/airless,
/area/tether_away/debrisfield/explored)
"v" = (
/obj/structure/rack,
/turf/floor/shuttle/blue/airless,
/area/tether_away/debrisfield/explored)
"w" = (
/obj/effect/decal/cleanable/generic,
/turf/floor/shuttle/blue/airless,
/area/tether_away/debrisfield/explored)
"x" = (
/obj/structure/tank_rack/oxygen,
/turf/floor/shuttle/blue/airless,
/area/tether_away/debrisfield/explored)
"y" = (
/obj/effect/decal/cleanable/blood/oil,
/turf/floor/shuttle/blue/airless,
/area/tether_away/debrisfield/explored)
"z" = (
/obj/machinery/constructable_frame/computerframe{
	dir = 1
	},
/turf/floor/shuttle/blue/airless,
/area/tether_away/debrisfield/explored)
"A" = (
/obj/machinery/suit_cycler/medical,
/turf/floor/shuttle/blue/airless,
/area/tether_away/debrisfield/explored)
"B" = (
/mob/living/bot/medbot{
	name = "Dr. Crusty"
	},
/turf/floor/shuttle/blue/airless,
/area/tether_away/debrisfield/explored)
"C" = (
/obj/effect/decal/cleanable/dirt,
/obj/random/firstaid,
/turf/floor/airless,
/area/tether_away/debrisfield/explored)
"D" = (
/obj/effect/decal/cleanable/dirt,
/obj/item/storage/firstaid/adv,
/turf/floor/airless,
/area/tether_away/debrisfield/explored)
"E" = (
/obj/item/shard/shrapnel,
/turf/exterior/barren,
/area/tether_away/debrisfield/explored)
"F" = (
/obj/item/stack/material/sheet/mapped/steel,
/turf/exterior/barren,
/area/tether_away/debrisfield/explored)
"G" = (
/obj/item/stack/material/rods,
/turf/exterior/barren,
/area/tether_away/debrisfield/explored)
"H" = (
/obj/effect/decal/cleanable/dirt,
/obj/item/stack/material/sheet/mapped/steel,
/turf/floor/airless,
/area/tether_away/debrisfield/explored)
"I" = (
/obj/effect/decal/cleanable/dirt,
/obj/item/stack/material/rods,
/turf/floor/airless,
/area/tether_away/debrisfield/explored)
"J" = (
/obj/effect/decal/cleanable/dirt,
/obj/item/shard/shrapnel,
/turf/floor/airless,
/area/tether_away/debrisfield/explored)
"K" = (
/obj/item/shard/shrapnel,
/turf/floor/shuttle/blue/airless,
/area/tether_away/debrisfield/explored)
"L" = (
/obj/tether_away_spawner/debrisfield/carp,
/turf/template_noop,
/area/tether_away/debrisfield/explored)
"M" = (
/turf/wall/shuttle/hard_corner,
/area/tether_away/debrisfield/explored)

(1,1,1) = {"
a
a
a
a
a
a
a
a
a
a
a
a
a
a
a
a
a
a
a
a
"}
(2,1,1) = {"
a
a
a
a
a
a
a
b
b
b
b
b
b
b
b
a
a
a
a
a
"}
(3,1,1) = {"
a
a
a
a
b
b
b
b
b
b
b
b
b
b
b
b
b
b
a
a
"}
(4,1,1) = {"
a
a
b
b
b
b
b
b
b
b
b
b
b
b
b
b
b
b
b
a
"}
(5,1,1) = {"
a
b
b
b
b
b
b
b
b
b
b
b
b
b
b
b
b
b
b
a
"}
(6,1,1) = {"
a
b
b
b
b
b
b
b
b
b
b
b
b
b
b
b
b
b
b
a
"}
(7,1,1) = {"
a
b
b
b
b
b
b
b
b
b
b
b
b
b
b
b
b
b
b
a
"}
(8,1,1) = {"
a
b
b
b
b
b
b
b
b
b
b
b
b
b
b
b
b
b
b
a
"}
(9,1,1) = {"
a
b
b
b
b
b
b
b
b
b
b
b
b
b
b
b
b
b
b
a
"}
(10,1,1) = {"
a
b
b
b
b
b
b
b
b
b
b
b
b
b
b
b
b
b
b
a
"}
(11,1,1) = {"
a
b
b
b
b
b
b
b
b
b
b
b
b
b
b
b
b
b
b
a
"}
(12,1,1) = {"
a
b
b
b
b
b
b
b
b
b
b
b
b
b
b
b
b
b
b
a
"}
(13,1,1) = {"
a
b
b
b
b
b
b
F
G
E
E
G
d
b
b
b
b
b
a
a
"}
(14,1,1) = {"
a
a
b
b
c
g
E
n
q
r
H
D
J
g
c
b
a
a
a
a
"}
(15,1,1) = {"
a
a
a
a
c
h
l
C
H
s
n
I
w
y
c
a
a
a
a
a
"}
(16,1,1) = {"
a
a
a
a
c
c
c
c
M
f
f
f
K
z
c
a
a
a
a
a
"}
(17,1,1) = {"
a
a
a
a
c
i
m
o
c
f
f
c
c
c
c
a
a
a
a
a
"}
(18,1,1) = {"
a
a
a
a
c
f
f
f
f
f
f
u
x
A
c
a
a
a
a
a
"}
(19,1,1) = {"
a
a
a
a
e
B
f
f
c
f
f
f
f
f
e
a
a
a
a
a
"}
(20,1,1) = {"
a
a
a
a
e
f
f
f
c
f
f
f
f
f
e
a
a
a
a
a
"}
(21,1,1) = {"
a
a
a
a
c
j
j
p
c
t
c
v
v
v
c
a
a
a
a
a
"}
(22,1,1) = {"
a
a
a
a
c
c
c
c
c
f
c
c
c
c
c
a
a
a
a
a
"}
(23,1,1) = {"
a
L
a
a
c
k
k
k
M
t
M
k
k
k
c
a
a
a
L
a
"}
(24,1,1) = {"
a
a
a
a
a
a
a
a
a
a
a
a
a
a
a
a
a
a
a
a
"}
(25,1,1) = {"
a
a
a
a
a
a
a
a
a
a
a
a
a
a
a
a
a
a
a
a
"}
