//MAP CONVERTED BY dmm2tgm.py THIS HEADER COMMENT PREVENTS RECONVERSION, DO NOT REMOVE
"aa" = (
/turf/template_noop,
/area/tether_away/debrisfield/explored)
"ab" = (
/turf/wall/shuttle,
/area/tether_away/debrisfield/explored)
"ac" = (
/obj/structure/shuttle/engine/propulsion{
	dir = 1
	},
/turf/floor/airless,
/area/tether_away/debrisfield/explored)
"ad" = (
/obj/structure/closet/crate/secure/engineering,
/obj/item/screwdriver/power,
/obj/item/crowbar/power,
/obj/item/screwdriver/power,
/obj/item/crowbar/power,
/obj/effect/decal/cleanable/dirt,
/turf/floor/airless,
/area/tether_away/debrisfield/explored)
"ae" = (
/obj/structure/closet/crate/trashcart,
/turf/template_noop,
/area/tether_away/debrisfield/explored)
"af" = (
/obj/structure/lattice,
/obj/structure/girder/displaced,
/turf/template_noop,
/area/tether_away/debrisfield/explored)
"ag" = (
/obj/effect/decal/cleanable/dirt,
/turf/floor/airless,
/area/tether_away/debrisfield/explored)
"ah" = (
/obj/structure/lattice,
/turf/template_noop,
/area/tether_away/debrisfield/explored)
"ai" = (
/turf/floor/airless,
/area/tether_away/debrisfield/explored)
"aj" = (
/turf/floor/shuttle/white/airless,
/area/tether_away/debrisfield/explored)
"ak" = (
/obj/effect/decal/cleanable/dirt,
/obj/item/shard/shrapnel,
/turf/floor/airless,
/area/tether_away/debrisfield/explored)
"al" = (
/obj/structure/ghost_pod/manual/lost_drone/dogborg,
/turf/floor/shuttle/blue/airless,
/area/tether_away/debrisfield/explored)
"am" = (
/obj/effect/decal/cleanable/dirt,
/obj/effect/decal/cleanable/blood/oil,
/turf/floor/airless,
/area/tether_away/debrisfield/explored)
"an" = (
/obj/structure/girder/displaced,
/turf/template_noop,
/area/tether_away/debrisfield/explored)
"ao" = (
/obj/structure/girder/displaced,
/turf/floor/shuttle/white/airless,
/area/tether_away/debrisfield/explored)
"ap" = (
/obj/effect/decal/cleanable/dirt,
/obj/effect/decal/cleanable/generic,
/turf/floor/airless,
/area/tether_away/debrisfield/explored)
"aq" = (
/obj/item/stack/material/sheet/mapped/steel,
/obj/effect/decal/cleanable/dirt,
/turf/floor/airless,
/area/tether_away/debrisfield/explored)
"ar" = (
/obj/item/inflatable/torn,
/turf/floor/shuttle/white/airless,
/area/tether_away/debrisfield/explored)
"as" = (
/obj/structure/shuttle/window,
/obj/structure/grille,
/turf/floor/airless,
/area/tether_away/debrisfield/explored)
"at" = (
/obj/item/inflatable/door/torn,
/turf/floor/shuttle/white/airless,
/area/tether_away/debrisfield/explored)
"au" = (
/obj/structure/inflatable,
/turf/floor/shuttle/white/airless,
/area/tether_away/debrisfield/explored)
"av" = (
/obj/structure/door_assembly/door_assembly_com,
/turf/floor/shuttle/white/airless,
/area/tether_away/debrisfield/explored)
"aw" = (
/obj/structure/lattice,
/obj/item/stack/material/sheet/mapped/steel,
/turf/template_noop,
/area/tether_away/debrisfield/explored)
"ax" = (
/obj/structure/lattice,
/obj/item/stack/material/sheet/mapped/steel,
/obj/item/shard/shrapnel,
/turf/template_noop,
/area/tether_away/debrisfield/explored)
"ay" = (
/obj/item/stack/material/rods,
/turf/template_noop,
/area/tether_away/debrisfield/explored)
"az" = (
/obj/structure/girder,
/turf/floor/shuttle/white/airless,
/area/tether_away/debrisfield/explored)
"aA" = (
/turf/floor/shuttle/blue/airless,
/area/tether_away/debrisfield/explored)
"aB" = (
/obj/structure/girder,
/obj/effect/decal/cleanable/dirt,
/turf/floor/airless,
/area/tether_away/debrisfield/explored)
"aD" = (
/obj/structure/girder/displaced,
/obj/effect/decal/cleanable/dirt,
/turf/floor/airless,
/area/tether_away/debrisfield/explored)
"aE" = (
/obj/structure/lattice,
/obj/effect/decal/cleanable/molten_item,
/turf/template_noop,
/area/tether_away/debrisfield/explored)
"aF" = (
/obj/structure/closet/crate/secure/engineering,
/obj/item/weldingtool/experimental,
/obj/item/weldingtool/electric,
/obj/item/weldingtool/electric,
/turf/template_noop,
/area/tether_away/debrisfield/explored)
"aG" = (
/obj/item/shard/shrapnel,
/turf/template_noop,
/area/tether_away/debrisfield/explored)
"aH" = (
/obj/structure/lattice,
/obj/structure/closet/crate/secure/engineering,
/obj/item/stack/material/aerogel/mapped/tritium/fifty,
/turf/template_noop,
/area/tether_away/debrisfield/explored)
"aJ" = (
/obj/structure/grille,
/obj/item/shard,
/obj/effect/decal/cleanable/dirt,
/turf/floor/airless,
/area/tether_away/debrisfield/explored)
"aK" = (
/obj/item/shard,
/obj/effect/decal/cleanable/dirt,
/turf/floor/airless,
/area/tether_away/debrisfield/explored)
"aL" = (
/obj/item/inflatable/torn,
/obj/item/remains,
/obj/item/clothing/under/cargotech,
/obj/item/clothing/head/soft,
/turf/floor/shuttle/white/airless,
/area/tether_away/debrisfield/explored)
"aM" = (
/obj/structure/closet/secure_closet/cargotech{
	name = "cargotech locker"
	},
/turf/floor/shuttle/blue/airless,
/area/tether_away/debrisfield/explored)
"aN" = (
/obj/structure/closet/emcloset,
/turf/floor/shuttle/blue/airless,
/area/tether_away/debrisfield/explored)
"aO" = (
/obj/item/inflatable/door/torn,
/obj/item/remains,
/obj/item/clothing/under/cargotech,
/obj/item/clothing/head/soft,
/turf/floor/shuttle/white/airless,
/area/tether_away/debrisfield/explored)
"aP" = (
/obj/machinery/computer/shuttle{
	dir = 4
	},
/turf/floor/shuttle/blue/airless,
/area/tether_away/debrisfield/explored)
"aQ" = (
/obj/structure/bed/chair{
	dir = 8
	},
/turf/floor/shuttle/white/airless,
/area/tether_away/debrisfield/explored)
"aR" = (
/obj/structure/closet/secure_closet/quartermaster{
	name = "quartermaster locker"
	},
/obj/item/clothing/under/mbill,
/obj/item/clothing/head/soft/mbill,
/turf/floor/shuttle/white/airless,
/area/tether_away/debrisfield/explored)
"aS" = (
/obj/structure/closet/crate/secure/bin,
/turf/floor/shuttle/white/airless,
/area/tether_away/debrisfield/explored)
"aT" = (
/obj/structure/closet/emcloset,
/turf/floor/shuttle/white/airless,
/area/tether_away/debrisfield/explored)
"aU" = (
/obj/structure/bed/chair{
	dir = 4
	},
/turf/floor/shuttle/white/airless,
/area/tether_away/debrisfield/explored)
"aV" = (
/obj/machinery/computer/shuttle{
	dir = 8
	},
/turf/floor/shuttle/blue/airless,
/area/tether_away/debrisfield/explored)
"aW" = (
/obj/item/remains,
/obj/item/clothing/under/mbill,
/obj/item/clothing/head/soft/mbill,
/turf/floor/shuttle/white/airless,
/area/tether_away/debrisfield/explored)
"aX" = (
/obj/structure/bed/chair,
/turf/floor/shuttle/blue/airless,
/area/tether_away/debrisfield/explored)
"aY" = (
/obj/structure/bed/chair/comfy/teal,
/turf/floor/shuttle/white/airless,
/area/tether_away/debrisfield/explored)
"aZ" = (
/obj/machinery/computer/shuttle{
	dir = 1
	},
/turf/floor/shuttle/blue/airless,
/area/tether_away/debrisfield/explored)
"bb" = (
/obj/structure/lattice,
/obj/item/shard/shrapnel,
/turf/template_noop,
/area/tether_away/debrisfield/explored)
"bc" = (
/obj/structure/lattice,
/obj/effect/decal/cleanable/molten_item,
/obj/item/shard/shrapnel,
/turf/template_noop,
/area/tether_away/debrisfield/explored)
"bd" = (
/turf/wall/shuttle/hard_corner,
/area/tether_away/debrisfield/explored)

(1,1,1) = {"
aa
aa
aa
aa
aa
aa
aa
aa
aa
aa
aa
aa
aa
aa
aa
aa
aa
aa
aa
aa
aa
aa
aa
aa
aa
aa
aa
aa
"}
(2,1,1) = {"
aa
ab
ab
ab
ab
ag
ak
aa
aa
aa
ah
bb
ah
ah
aB
aJ
as
ab
ab
as
as
ab
aa
aa
aa
aa
aa
aa
"}
(3,1,1) = {"
aa
ac
bd
ag
ad
am
bb
aa
aa
ah
ah
ah
ah
ah
ap
aK
aA
aN
ab
aP
aP
ab
ab
aa
aa
aa
aa
aa
"}
(4,1,1) = {"
aa
aa
aB
ag
am
ah
aw
bc
aa
aa
aa
aa
aH
ah
ah
ai
aj
aj
ab
aQ
aQ
aA
ab
ab
aa
aa
aa
aa
"}
(5,1,1) = {"
aa
aa
aa
af
aa
aa
aa
aa
aa
aa
aG
aa
ay
ah
ag
aB
ab
ab
ab
aj
aj
aj
aA
ab
as
ab
aa
aa
"}
(6,1,1) = {"
aa
aa
ac
bd
am
ah
aa
aw
aa
aa
aa
aa
bb
ah
ag
ag
ar
au
ab
aR
aj
aj
aj
aX
aZ
as
aa
aa
"}
(7,1,1) = {"
aa
aa
ae
ab
am
ax
ah
ah
aa
aa
an
ah
ah
am
ag
ar
aL
au
ab
aj
aj
aj
aj
aj
aZ
as
aa
aa
"}
(8,1,1) = {"
aa
aa
aa
aD
ah
aa
aa
aa
aa
aa
aa
ah
ah
ag
ap
aj
at
aO
av
aj
aj
aj
aW
aY
aZ
as
aa
aa
"}
(9,1,1) = {"
aa
aa
aa
ab
ah
ah
aa
aa
aa
aa
aa
ah
ag
ag
aj
ar
au
au
ab
aS
aj
aj
aj
aj
aZ
as
aa
aa
"}
(10,1,1) = {"
aa
aa
ac
ab
ap
ah
aG
aF
aa
aa
aG
aE
ap
ag
ao
aj
ar
au
ab
aT
aj
aj
aj
aX
aZ
as
aa
aa
"}
(11,1,1) = {"
aa
aa
ac
ab
aq
ag
bb
aa
aa
aa
aG
ag
aq
ag
ao
aj
az
ab
ab
aj
aj
aj
aA
ab
as
ab
aa
aa
"}
(12,1,1) = {"
aa
aa
ac
ab
aA
aD
ah
aa
ay
aa
ag
ag
ag
ab
aj
aj
aj
aj
ab
aU
aU
aA
ab
ab
aa
aa
aa
aa
"}
(13,1,1) = {"
aa
aa
ac
ab
aA
aA
ag
ag
ah
ah
ag
ag
am
ab
al
aA
aM
aM
ab
aV
aV
ab
ab
aa
aa
aa
aa
aa
"}
(14,1,1) = {"
aa
aa
ab
bd
aB
aB
aD
ag
ag
aB
aB
aB
ab
ab
ab
as
as
ab
ab
as
as
ab
aa
aa
aa
aa
aa
aa
"}
(15,1,1) = {"
aa
aa
aa
aa
aa
aa
aa
aa
aa
aa
aa
aa
aa
aa
aa
aa
aa
aa
aa
aa
aa
aa
aa
aa
aa
aa
aa
aa
"}
