//MAP CONVERTED BY dmm2tgm.py THIS HEADER COMMENT PREVENTS RECONVERSION, DO NOT REMOVE
"a" = (
/turf/template_noop,
/area/template_noop)
"b" = (
/turf/template_noop,
/area/submap/virgo2/CaveS)
"c" = (
/obj/item/ammo_casing/a45,
/turf/template_noop,
/area/submap/virgo2/CaveS)
"d" = (
/turf/mineral/ignore_mapgen/virgo2,
/area/submap/virgo2/CaveS)
"f" = (
/obj/tether_away_spawner/aerostat_surface,
/turf/exterior/barren,
/area/submap/virgo2/CaveS)
"g" = (
/obj/effect/spider/stickyweb,
/turf/exterior/barren,
/area/submap/virgo2/CaveS)
"h" = (
/obj/item/ammo_casing/a45,
/obj/item/ammo_casing/a45,
/turf/template_noop,
/area/submap/virgo2/CaveS)
"j" = (
/obj/item/clothing/accessory/storage/vest,
/obj/item/knife/combat,
/turf/exterior/barren,
/area/submap/virgo2/CaveS)
"k" = (
/obj/tether_away_spawner/aerostat_surface,
/turf/floor,
/area/submap/virgo2/CaveS)
"l" = (
/obj/effect/decal/cleanable/cobweb,
/turf/exterior/barren,
/area/submap/virgo2/CaveS)
"n" = (
/obj/effect/decal/cleanable/cobweb2,
/turf/exterior/barren,
/area/submap/virgo2/CaveS)
"o" = (
/obj/effect/mine,
/turf/exterior/barren,
/area/submap/virgo2/CaveS)
"r" = (
/turf/exterior/barren,
/area/submap/virgo2/CaveS)
"u" = (
/turf/floor,
/area/submap/virgo2/CaveS)
"v" = (
/obj/structure/closet/crate,
/obj/item/stack/cable_coil,
/obj/item/stack/cable_coil,
/obj/item/storage/toolbox,
/obj/random/toolbox,
/turf/floor,
/area/submap/virgo2/CaveS)
"w" = (
/obj/structure/loot_pile/surface,
/turf/floor,
/area/submap/virgo2/CaveS)
"x" = (
/obj/structure/table/woodentable,
/turf/floor,
/area/submap/virgo2/CaveS)
"y" = (
/obj/machinery/port_gen/pacman,
/obj/structure/cable{
	icon_state = "0-2"
	},
/turf/floor,
/area/submap/virgo2/CaveS)
"z" = (
/turf/wall,
/area/submap/virgo2/CaveS)
"A" = (
/obj/structure/closet/crate,
/obj/item/chems/hypospray,
/obj/item/chems/glass/bottle/sedatives,
/obj/item/chems/glass/bottle/antitoxin,
/obj/item/chems/pill/antitox,
/obj/item/chems/pill/antitox,
/obj/item/chems/pill/antitox,
/obj/item/chems/pill/paracetamol,
/obj/random/firstaid,
/obj/item/storage/firstaid/combat,
/turf/floor,
/area/submap/virgo2/CaveS)
"B" = (
/obj/structure/cable{
	icon_state = "1-2";
	pixel_y = 0
	},
/turf/floor,
/area/submap/virgo2/CaveS)
"C" = (
/obj/structure/closet/crate,
/obj/random/contraband,
/obj/random/contraband,
/obj/random/contraband,
/obj/random/energy,
/obj/item/star,
/obj/item/star,
/obj/item/star,
/obj/item/star,
/obj/item/star,
/turf/floor,
/area/submap/virgo2/CaveS)
"E" = (
/obj/structure/cable{
	icon_state = "1-4"
	},
/turf/floor,
/area/submap/virgo2/CaveS)
"F" = (
/obj/structure/cable{
	icon_state = "4-8";
	pixel_x = 0
	},
/turf/floor,
/area/submap/virgo2/CaveS)
"G" = (
/obj/machinery/computer/modular/preset/cardslot/command,
/obj/structure/cable{
	icon_state = "0-8"
	},
/turf/floor,
/area/submap/virgo2/CaveS)

(1,1,1) = {"
a
a
a
a
a
a
a
a
a
a
a
a
a
a
a
a
a
a
a
a
a
a
a
a
a
a
a
a
a
a
a
a
a
a
a
a
a
a
a
a
"}
(2,1,1) = {"
a
b
b
b
b
b
b
b
b
b
b
b
b
b
b
b
b
b
b
b
b
b
b
b
b
b
b
b
b
b
b
b
b
b
b
b
b
b
b
a
"}
(3,1,1) = {"
a
b
b
b
b
b
b
b
b
b
b
b
b
b
b
b
b
b
d
d
d
d
d
d
d
d
d
d
d
d
d
d
d
b
b
b
b
b
b
a
"}
(4,1,1) = {"
a
b
b
b
b
b
b
b
b
b
b
b
b
b
d
d
d
d
d
d
d
d
d
d
d
d
d
d
d
d
d
d
d
d
d
d
b
b
b
a
"}
(5,1,1) = {"
a
b
b
b
b
b
b
b
b
b
b
d
d
d
d
d
d
d
d
d
d
d
d
d
r
r
d
d
r
r
d
d
d
d
d
d
d
d
d
a
"}
(6,1,1) = {"
a
b
b
b
b
b
b
b
b
d
d
d
d
d
d
d
d
d
d
d
d
d
d
r
r
r
r
r
r
r
r
d
d
d
d
d
d
d
d
a
"}
(7,1,1) = {"
a
b
b
b
b
b
b
b
b
d
d
d
d
d
d
r
g
d
d
d
d
d
d
r
r
f
r
r
r
r
r
d
d
d
d
d
d
d
b
a
"}
(8,1,1) = {"
a
b
b
b
b
b
b
b
b
d
d
d
d
d
d
r
r
r
d
d
d
d
r
r
r
r
r
r
r
r
r
r
d
d
d
d
d
d
b
a
"}
(9,1,1) = {"
a
b
b
b
b
b
b
b
b
d
d
d
d
d
j
r
r
r
d
d
d
d
r
r
r
r
r
r
r
r
r
r
d
d
d
d
d
b
b
a
"}
(10,1,1) = {"
a
b
b
b
b
b
b
b
b
d
d
d
d
d
d
r
r
r
r
r
d
d
d
d
d
r
r
r
r
f
r
r
r
d
d
d
d
b
b
a
"}
(11,1,1) = {"
a
b
b
b
b
b
b
b
b
b
d
d
d
d
r
r
r
f
r
r
r
d
d
d
d
d
g
r
r
r
r
r
g
d
d
d
d
b
b
a
"}
(12,1,1) = {"
a
b
b
b
b
b
b
b
b
b
d
d
d
d
r
r
r
r
r
r
r
r
d
d
d
d
d
r
r
r
r
d
d
d
d
d
d
b
b
a
"}
(13,1,1) = {"
a
b
b
b
b
b
b
b
b
b
d
d
d
d
g
r
r
d
r
r
r
r
d
d
d
d
d
r
r
d
r
d
d
d
d
d
d
d
b
a
"}
(14,1,1) = {"
a
b
b
b
b
b
b
b
b
b
b
d
d
d
d
d
d
d
d
n
r
r
d
d
d
d
d
r
r
d
d
d
d
d
d
d
d
d
d
a
"}
(15,1,1) = {"
a
b
b
b
b
b
b
b
b
c
b
b
d
d
d
d
d
d
d
d
r
r
r
r
r
d
d
r
r
d
d
d
d
d
d
d
d
d
d
a
"}
(16,1,1) = {"
a
b
b
b
b
b
b
b
b
b
b
b
b
d
d
d
b
b
d
d
r
r
r
r
r
r
r
r
g
d
d
d
d
d
d
d
d
d
d
a
"}
(17,1,1) = {"
a
b
b
b
b
b
c
b
b
b
b
b
b
b
b
b
b
d
d
d
r
r
d
d
r
r
r
r
d
d
d
d
d
d
d
d
d
d
d
a
"}
(18,1,1) = {"
a
b
b
b
b
b
b
b
b
b
b
b
b
b
b
b
d
d
d
d
r
r
d
d
d
r
r
d
d
d
d
g
g
f
d
d
d
d
b
a
"}
(19,1,1) = {"
a
b
b
b
b
b
b
b
b
b
h
c
b
b
d
d
d
d
d
d
r
r
d
d
d
r
o
r
d
d
d
r
r
r
r
d
d
d
b
a
"}
(20,1,1) = {"
a
b
b
b
b
b
b
b
b
c
b
b
b
b
d
d
d
d
d
l
r
r
r
d
d
r
r
r
g
d
r
r
r
r
g
d
d
b
b
a
"}
(21,1,1) = {"
a
b
b
b
b
b
b
b
b
b
b
b
b
d
d
d
d
d
d
r
r
r
d
d
d
d
r
r
r
r
r
r
r
r
d
d
d
b
b
a
"}
(22,1,1) = {"
a
b
b
b
b
b
b
b
b
b
b
b
d
d
d
d
d
d
d
r
r
r
d
d
d
d
r
r
r
o
r
r
r
r
d
d
d
d
d
a
"}
(23,1,1) = {"
a
b
b
b
c
b
b
b
b
b
b
d
d
d
d
d
d
d
d
r
r
r
d
d
d
d
o
r
r
r
g
d
d
d
d
d
d
d
b
a
"}
(24,1,1) = {"
a
b
b
b
b
b
c
b
b
f
r
g
d
d
d
d
d
d
d
r
r
r
d
d
d
d
g
g
r
r
d
d
d
d
d
d
d
d
b
a
"}
(25,1,1) = {"
a
b
b
b
b
b
c
c
d
g
r
r
g
d
d
d
d
d
d
r
r
r
d
d
d
d
d
d
r
r
r
r
r
d
d
d
d
d
d
a
"}
(26,1,1) = {"
a
b
b
b
b
b
c
d
d
d
d
g
r
d
d
l
r
r
o
r
r
r
g
d
d
d
d
d
r
r
r
r
f
r
r
d
d
d
d
a
"}
(27,1,1) = {"
a
b
b
b
b
b
d
d
d
d
d
g
r
r
r
r
r
r
r
d
d
r
r
o
d
d
d
r
r
r
u
u
u
r
r
r
d
d
d
a
"}
(28,1,1) = {"
a
b
b
b
b
b
d
d
d
d
d
d
r
r
r
f
r
d
d
d
d
n
r
r
d
d
r
r
r
u
y
B
E
u
f
r
d
d
d
a
"}
(29,1,1) = {"
a
b
b
b
b
b
d
d
d
d
d
d
d
g
r
r
r
d
d
d
d
d
r
r
d
r
r
u
u
x
z
z
F
u
w
r
d
d
d
a
"}
(30,1,1) = {"
a
b
b
b
b
b
d
d
d
d
d
d
d
d
r
r
r
d
d
d
d
d
r
r
d
r
r
k
u
x
z
z
G
u
u
d
d
d
b
a
"}
(31,1,1) = {"
a
b
b
b
b
b
d
d
d
d
d
d
d
d
r
r
r
d
d
l
o
r
r
r
d
d
r
v
u
u
A
C
u
u
d
d
d
b
b
a
"}
(32,1,1) = {"
a
b
b
b
b
b
b
d
d
d
d
d
d
d
r
r
r
r
r
r
r
r
r
d
d
d
r
r
w
u
r
r
u
d
d
d
b
b
b
a
"}
(33,1,1) = {"
a
b
b
b
b
b
b
d
d
d
d
d
d
d
d
r
d
n
r
d
d
d
d
d
d
d
d
r
r
r
f
r
d
d
d
d
b
b
b
a
"}
(34,1,1) = {"
a
b
b
b
b
b
b
b
d
d
d
d
d
d
d
d
d
d
d
d
d
d
d
d
d
d
d
r
d
r
r
d
d
d
d
b
b
b
b
a
"}
(35,1,1) = {"
a
b
b
b
b
b
b
b
d
d
d
d
d
d
d
d
d
d
d
d
d
d
d
d
d
d
d
d
d
d
d
d
d
d
d
b
b
b
b
a
"}
(36,1,1) = {"
a
b
b
b
b
b
b
d
d
d
d
d
b
b
d
d
d
d
d
d
d
d
d
d
d
d
b
d
d
d
d
d
d
d
b
b
b
b
b
a
"}
(37,1,1) = {"
a
b
b
b
b
b
b
d
d
d
d
b
b
b
b
b
d
d
d
d
d
d
d
d
b
b
b
b
b
b
d
d
b
b
b
b
b
b
b
a
"}
(38,1,1) = {"
a
b
b
b
b
b
b
b
b
b
b
b
b
b
b
b
b
b
d
d
d
d
d
b
b
b
b
b
b
b
b
b
b
b
b
b
b
b
b
a
"}
(39,1,1) = {"
a
b
b
b
b
b
b
b
b
b
b
b
b
b
b
b
b
b
b
b
d
d
b
b
b
b
b
b
b
b
b
b
b
b
b
b
b
b
b
a
"}
(40,1,1) = {"
a
a
a
a
a
a
a
a
a
a
a
a
a
a
a
a
a
a
a
a
a
a
a
a
a
a
a
a
a
a
a
a
a
a
a
a
a
a
a
a
"}
