//MAP CONVERTED BY dmm2tgm.py THIS HEADER COMMENT PREVENTS RECONVERSION, DO NOT REMOVE
"a" = (
/turf/template_noop,
/area/template_noop)
"b" = (
/turf/template_noop,
/area/submap/virgo2/MHR)
"c" = (
/turf/exterior/barren,
/area/template_noop)
"d" = (
/turf/exterior/barren,
/area/submap/virgo2/MHR)
"e" = (
/turf/mineral/ignore_mapgen/virgo2,
/area/submap/virgo2/MHR)
"f" = (
/obj/effect/decal/cleanable/spiderling_remains,
/turf/exterior/barren,
/area/submap/virgo2/MHR)
"h" = (
/obj/structure/rack,
/obj/item/storage/backpack,
/turf/exterior/barren,
/area/submap/virgo2/MHR)
"i" = (
/obj/structure/table,
/turf/exterior/barren,
/area/submap/virgo2/MHR)
"j" = (
/obj/structure/table,
/obj/item/paper{
	info = "Do not enter the cave. The estimated active time of the Vicerators is much longer due to the improvements on the rotor bearings. It's estimated to be roughly a few months before we start to see any chancces of mechanical failure. ";
	name = "NOTICE: DO NOT ENTER"
	},
/turf/exterior/barren,
/area/submap/virgo2/MHR)
"k" = (
/obj/effect/decal/cleanable/cobweb2,
/turf/exterior/barren,
/area/submap/virgo2/MHR)
"l" = (
/obj/tether_away_spawner/aerostat_surface,
/turf/exterior/barren,
/area/submap/virgo2/MHR)
"n" = (
/obj/effect/decal/cleanable/spiderling_remains,
/obj/tether_away_spawner/aerostat_surface,
/turf/exterior/barren,
/area/submap/virgo2/MHR)
"o" = (
/obj/effect/decal/cleanable/cobweb,
/turf/exterior/barren,
/area/submap/virgo2/MHR)
"p" = (
/obj/effect/decal/cleanable/spiderling_remains,
/obj/effect/decal/cleanable/cobweb,
/turf/exterior/barren,
/area/submap/virgo2/MHR)
"q" = (
/obj/item/remains/robot,
/turf/exterior/barren,
/area/submap/virgo2/MHR)
"r" = (
/obj/item/remains,
/obj/item/clothing/mask/gas/explorer,
/obj/item/twohanded/fireaxe,
/turf/exterior/barren,
/area/submap/virgo2/MHR)

(1,1,1) = {"
a
a
a
a
a
a
a
a
a
a
a
a
a
a
a
a
a
a
a
a
"}
(2,1,1) = {"
a
b
b
b
b
b
b
b
b
b
b
b
b
b
b
b
b
b
b
a
"}
(3,1,1) = {"
a
d
d
d
d
b
b
b
e
e
e
e
e
b
b
b
b
b
b
a
"}
(4,1,1) = {"
c
d
d
d
d
b
b
e
e
e
e
e
e
e
e
e
b
b
b
a
"}
(5,1,1) = {"
c
d
d
d
b
b
e
e
e
e
e
e
e
e
e
e
e
b
b
a
"}
(6,1,1) = {"
c
d
d
d
d
e
e
e
e
e
p
d
d
l
e
e
e
e
b
a
"}
(7,1,1) = {"
c
d
d
d
h
e
e
e
e
e
l
d
d
d
f
e
e
e
b
a
"}
(8,1,1) = {"
c
d
d
d
i
e
e
e
e
d
d
d
d
d
e
e
e
e
b
a
"}
(9,1,1) = {"
c
d
d
d
j
e
e
e
e
d
d
d
n
d
e
e
e
e
b
a
"}
(10,1,1) = {"
c
d
d
d
e
e
e
e
e
k
d
d
d
d
d
e
e
e
b
a
"}
(11,1,1) = {"
c
d
d
d
e
e
e
e
e
e
q
d
d
d
d
e
e
e
b
a
"}
(12,1,1) = {"
c
d
d
d
e
e
e
e
e
e
f
d
d
d
d
e
e
e
b
a
"}
(13,1,1) = {"
c
d
d
f
e
e
e
e
e
o
d
l
d
d
d
e
e
e
b
a
"}
(14,1,1) = {"
c
d
d
d
d
e
e
e
d
d
d
d
d
d
l
e
e
b
b
a
"}
(15,1,1) = {"
c
d
f
d
d
d
d
d
d
d
d
d
d
q
e
e
e
b
b
a
"}
(16,1,1) = {"
a
e
e
d
d
d
d
d
d
d
d
d
d
e
e
e
e
b
b
a
"}
(17,1,1) = {"
a
e
e
e
e
e
e
e
k
d
d
r
e
e
e
e
e
b
b
a
"}
(18,1,1) = {"
a
e
e
e
e
e
e
e
e
e
e
e
e
e
e
b
b
b
b
a
"}
(19,1,1) = {"
a
b
e
e
e
e
e
e
e
e
e
e
e
e
b
b
b
b
b
a
"}
(20,1,1) = {"
a
a
a
a
a
a
a
a
a
a
a
a
a
a
a
a
a
a
a
a
"}
