//MAP CONVERTED BY dmm2tgm.py THIS HEADER COMMENT PREVENTS RECONVERSION, DO NOT REMOVE
"aa" = (
/mob/living/simple_mob/mechanical/viscerator{
	maxbodytemp = 900;
	ai_holder_type = /datum/ai_holder/simple_mob/melee/evasive/returnhome
	},
/turf/floor/natural/barren,
/area/template_noop)
"ab" = (
/turf/template_noop,
/area/template_noop)
"ac" = (
/obj/item/remains,
/turf/floor/natural/barren,
/area/submap/virgo2/Rockybase)
"ad" = (
/turf/template_noop,
/area/submap/virgo2/Rockybase)
"ae" = (
/obj/machinery/door/airlock/external,
/turf/floor/tiled/techfloor/virgo2,
/area/submap/virgo2/Rockybase)
"af" = (
/mob/living/simple_mob/mechanical/combat_drone{
	desc = "An automated combat drone with an aged apperance.";
	faction = "syndicate";
	maxbodytemp = 900;
	ai_holder_type = /datum/ai_holder/simple_mob/ranged/kiting/threatening/returnhome
	},
/turf/floor/natural/barren,
/area/submap/virgo2/Rockybase)
"ag" = (
/turf/mineral/ignore_mapgen/virgo2,
/area/submap/virgo2/Rockybase)
"ah" = (
/obj/machinery/porta_turret/stationary,
/turf/floor/plating/virgo2,
/area/submap/virgo2/Rockybase)
"ai" = (
/obj/effect/decal/cleanable/blood,
/turf/floor/plating/virgo2,
/area/submap/virgo2/Rockybase)
"aj" = (
/obj/machinery/light,
/turf/floor/plating/virgo2,
/area/submap/virgo2/Rockybase)
"ak" = (
/obj/structure/hygiene/shower{
	dir = 4;
	icon_state = "shower";
	pixel_x = 5;
	pixel_y = 0
	},
/obj/structure/curtain/open/shower,
/obj/machinery/light/small{
	dir = 8
	},
/turf/floor/tiled/techfloor/virgo2,
/area/submap/virgo2/Rockybase)
"al" = (
/turf/wall/virgo2,
/area/submap/virgo2/Rockybase)
"am" = (
/obj/structure/sign/warning,
/turf/wall/virgo2,
/area/submap/virgo2/Rockybase)
"an" = (
/turf/floor/plating/virgo2,
/area/template_noop)
"ao" = (
/turf/floor/tiled/techfloor/virgo2,
/area/submap/virgo2/Rockybase)
"ap" = (
/obj/structure/hygiene/shower{
	dir = 8;
	icon_state = "shower";
	pixel_x = -5;
	pixel_y = 0
	},
/obj/structure/curtain/open/shower,
/obj/item/soap,
/turf/floor/tiled/techfloor/virgo2,
/area/submap/virgo2/Rockybase)
"aq" = (
/obj/structure/table/woodentable,
/turf/floor/tiled/techfloor/virgo2,
/area/submap/virgo2/Rockybase)
"ar" = (
/obj/structure/table/woodentable,
/obj/item/flashlight/lamp,
/turf/floor/tiled/techfloor/virgo2,
/area/submap/virgo2/Rockybase)
"as" = (
/obj/structure/closet{
	icon_closed = "cabinet_closed";
	icon_opened = "cabinet_open";
	icon_state = "cabinet_closed"
	},
/turf/floor/tiled/techfloor/virgo2,
/area/submap/virgo2/Rockybase)
"at" = (
/obj/structure/bed,
/obj/item/bedsheet,
/turf/floor/tiled/techfloor/virgo2,
/area/submap/virgo2/Rockybase)
"au" = (
/obj/structure/table/woodentable,
/obj/machinery/light{
	dir = 1
	},
/turf/floor/tiled/techfloor/virgo2,
/area/submap/virgo2/Rockybase)
"av" = (
/obj/structure/bed,
/obj/item/bedsheet,
/obj/item/toy/plushie/spider,
/turf/floor/tiled/techfloor/virgo2,
/area/submap/virgo2/Rockybase)
"aw" = (
/obj/structure/closet/l3closet/janitor,
/turf/floor/tiled/techfloor/virgo2,
/area/submap/virgo2/Rockybase)
"ax" = (
/mob/living/bot/cleanbot{
	faction = "malf_drone"
	},
/turf/floor/tiled/techfloor/virgo2,
/area/submap/virgo2/Rockybase)
"ay" = (
/obj/item/stool,
/turf/floor/tiled/techfloor/virgo2,
/area/submap/virgo2/Rockybase)
"az" = (
/obj/item/belt/janitor,
/obj/structure/table,
/turf/floor/tiled/techfloor/virgo2,
/area/submap/virgo2/Rockybase)
"aA" = (
/obj/structure/table,
/obj/item/modular_computer/laptop/preset/custom_loadout/advanced,
/turf/floor/tiled/techfloor/virgo2,
/area/submap/virgo2/Rockybase)
"aB" = (
/obj/structure/table,
/turf/floor/tiled/techfloor/virgo2,
/area/submap/virgo2/Rockybase)
"aC" = (
/obj/structure/rack,
/obj/item/gun/projectile/pistol,
/turf/floor/tiled/techfloor/virgo2,
/area/submap/virgo2/Rockybase)
"aD" = (
/obj/structure/rack,
/obj/item/gun/energy/gun/taser,
/turf/floor/tiled/techfloor/virgo2,
/area/submap/virgo2/Rockybase)
"aE" = (
/obj/machinery/light{
	dir = 1
	},
/turf/floor/tiled/techfloor/virgo2,
/area/submap/virgo2/Rockybase)
"aF" = (
/obj/machinery/vending/coffee,
/turf/floor/tiled/techfloor/virgo2,
/area/submap/virgo2/Rockybase)
"aH" = (
/obj/machinery/vending/hydronutrients,
/turf/floor/tiled/techfloor/virgo2,
/area/submap/virgo2/Rockybase)
"aI" = (
/obj/structure/closet/crate/hydroponics,
/turf/floor/tiled/techfloor/virgo2,
/area/submap/virgo2/Rockybase)
"aJ" = (
/obj/structure/hygiene/shower{
	dir = 4;
	icon_state = "shower";
	pixel_x = 5;
	pixel_y = 0
	},
/obj/structure/curtain/open/shower,
/turf/floor/tiled/techfloor/virgo2,
/area/submap/virgo2/Rockybase)
"aK" = (
/obj/structure/hygiene/shower{
	dir = 8;
	icon_state = "shower";
	pixel_x = -5;
	pixel_y = 0
	},
/obj/structure/curtain/open/shower,
/turf/floor/tiled/techfloor/virgo2,
/area/submap/virgo2/Rockybase)
"aL" = (
/obj/structure/janitorialcart,
/turf/floor/tiled/techfloor/virgo2,
/area/submap/virgo2/Rockybase)
"aM" = (
/obj/structure/table,
/obj/item/grenade/chem_grenade/cleaner,
/obj/item/grenade/chem_grenade/cleaner,
/obj/item/grenade/chem_grenade/cleaner,
/obj/machinery/light{
	icon_state = "tube1";
	dir = 4
	},
/turf/floor/tiled/techfloor/virgo2,
/area/submap/virgo2/Rockybase)
"aN" = (
/obj/machinery/light/small{
	dir = 8
	},
/turf/floor/tiled/techfloor/virgo2,
/area/submap/virgo2/Rockybase)
"aO" = (
/obj/structure/table,
/obj/item/paper{
	info = "Carl's absolutly fucked in the head. He's trying to squeeze as much drone production out as he can since he's worried we're gonna get found out but he's getting sloppier with each batch. Now's he's telling us he can speed the time on the IFF encoding. I already have a hard enough time getting these damn things not to stare at walls and now he's gonna shortchange the only part of these tincans that tells em not to turn us into paste on a wall. I told Richter to get out while he can, We're counting days before either some Sif task force shows up at our door or these things decide we aren't there friends anymore.";
	name = "Note"
	},
/turf/floor/tiled/techfloor/virgo2,
/area/submap/virgo2/Rockybase)
"aP" = (
/obj/structure/bed/chair{
	dir = 8
	},
/turf/floor/tiled/techfloor/virgo2,
/area/submap/virgo2/Rockybase)
"aQ" = (
/obj/machinery/vending/security,
/turf/floor/tiled/techfloor/virgo2,
/area/submap/virgo2/Rockybase)
"aR" = (
/obj/structure/rack,
/obj/item/box/ammo/shotgunshells,
/obj/item/box/ammo/shotgunshells,
/obj/item/box/ammo/shotgunshells,
/turf/floor/tiled/techfloor/virgo2,
/area/submap/virgo2/Rockybase)
"aS" = (
/obj/structure/hygiene/sink{
	dir = 4;
	icon_state = "sink";
	pixel_x = 11;
	pixel_y = 0
	},
/turf/floor/tiled/techfloor/virgo2,
/area/submap/virgo2/Rockybase)
"aT" = (
/obj/structure/hygiene/shower{
	dir = 8;
	icon_state = "shower";
	pixel_x = -5;
	pixel_y = 0
	},
/obj/structure/curtain/open/shower,
/obj/machinery/light/small{
	dir = 4;
	pixel_y = 0
	},
/turf/floor/tiled/techfloor/virgo2,
/area/submap/virgo2/Rockybase)
"aU" = (
/obj/item/mecha_parts/part/gygax_left_leg,
/turf/floor/tiled/techfloor/virgo2,
/area/submap/virgo2/Rockybase)
"aV" = (
/obj/machinery/light,
/turf/floor/tiled/techfloor/virgo2,
/area/submap/virgo2/Rockybase)
"aW" = (
/obj/structure/bed,
/obj/item/bedsheet,
/obj/item/gun/projectile/pistol,
/turf/floor/tiled/techfloor/virgo2,
/area/submap/virgo2/Rockybase)
"aX" = (
/obj/structure/closet/crate/trashcart,
/turf/floor/tiled/techfloor/virgo2,
/area/submap/virgo2/Rockybase)
"aY" = (
/obj/structure/loot_pile/maint/trash,
/turf/floor/tiled/techfloor/virgo2,
/area/submap/virgo2/Rockybase)
"aZ" = (
/obj/structure/table,
/obj/item/bag/trash,
/obj/item/bag/trash,
/turf/floor/tiled/techfloor/virgo2,
/area/submap/virgo2/Rockybase)
"ba" = (
/obj/structure/table,
/obj/item/paper_bin,
/turf/floor/tiled/techfloor/virgo2,
/area/submap/virgo2/Rockybase)
"bb" = (
/obj/machinery/light,
/obj/structure/table,
/obj/item/pen,
/turf/floor/tiled/techfloor/virgo2,
/area/submap/virgo2/Rockybase)
"bc" = (
/obj/structure/rack,
/turf/floor/tiled/techfloor/virgo2,
/area/submap/virgo2/Rockybase)
"bd" = (
/obj/machinery/portable_atmospherics/hydroponics,
/turf/floor/tiled/techfloor/virgo2,
/area/submap/virgo2/Rockybase)
"be" = (
/obj/machinery/door/airlock,
/turf/floor/tiled/techfloor/virgo2,
/area/submap/virgo2/Rockybase)
"bf" = (
/mob/living/bot/farmbot{
	faction = "malf_drone"
	},
/turf/floor/tiled/techfloor/virgo2,
/area/submap/virgo2/Rockybase)
"bg" = (
/obj/machinery/door/airlock/security{
	icon_state = "door_locked";
	locked = 1
	},
/turf/floor/tiled,
/area/submap/virgo2/Rockybase)
"bh" = (
/obj/machinery/portable_atmospherics/hydroponics,
/obj/machinery/light{
	icon_state = "tube1";
	dir = 4
	},
/turf/floor/tiled/techfloor/virgo2,
/area/submap/virgo2/Rockybase)
"bi" = (
/obj/machinery/vending/cola,
/turf/floor/tiled/techfloor/virgo2,
/area/submap/virgo2/Rockybase)
"bj" = (
/obj/structure/door_assembly,
/turf/floor/tiled/techfloor/virgo2,
/area/submap/virgo2/Rockybase)
"bk" = (
/obj/machinery/door/airlock,
/turf/floor/tiled,
/area/submap/virgo2/Rockybase)
"bl" = (
/mob/living/simple_mob/mechanical/combat_drone{
	desc = "An automated combat drone with an aged apperance.";
	faction = "syndicate";
	maxbodytemp = 900;
	ai_holder_type = /datum/ai_holder/simple_mob/ranged/kiting/threatening/returnhome
	},
/turf/floor/tiled/techfloor/virgo2,
/area/submap/virgo2/Rockybase)
"bm" = (
/obj/effect/decal/cleanable/blood,
/turf/floor/tiled/techfloor/virgo2,
/area/submap/virgo2/Rockybase)
"bn" = (
/obj/item/remains,
/turf/floor/tiled/techfloor/virgo2,
/area/submap/virgo2/Rockybase)
"bo" = (
/obj/machinery/vending/snack,
/turf/floor/tiled/techfloor/virgo2,
/area/submap/virgo2/Rockybase)
"bp" = (
/obj/item/stack/material/rods,
/obj/structure/girder,
/turf/floor/tiled/techfloor/virgo2,
/area/submap/virgo2/Rockybase)
"bq" = (
/turf/floor/plating/virgo2,
/area/submap/virgo2/Rockybase)
"br" = (
/obj/structure/sign/warning{
	desc = "A warning sign which reads 'HIGH VOLTAGE'";
	icon_state = "shock";
	name = "HIGH VOLTAGE";
	pixel_y = -32
	},
/turf/floor/tiled/techfloor/virgo2,
/area/submap/virgo2/Rockybase)
"bs" = (
/obj/item/mecha_parts/part/gygax_right_arm,
/turf/floor/tiled/techfloor/virgo2,
/area/submap/virgo2/Rockybase)
"bu" = (
/obj/structure/table,
/obj/item/paper{
	info = "I've decided to go forward and start some small scale tests of the Vicerator delivery grenades, Might as wall make sure they work like the real ones. There are a few Fauna areas nearbye and we're working to make sure the kinks in the code are worked out. Once we've made sure they stay flying we'll work on the IFF signals.";
	name = "V-Grenade Notice 2"
	},
/turf/floor/tiled/techfloor/virgo2,
/area/submap/virgo2/Rockybase)
"bv" = (
/obj/structure/table,
/obj/random/toolbox,
/obj/machinery/light{
	dir = 1
	},
/turf/floor/tiled/techfloor/virgo2,
/area/submap/virgo2/Rockybase)
"bw" = (
/obj/structure/table,
/obj/random/toolbox,
/turf/floor/tiled/techfloor/virgo2,
/area/submap/virgo2/Rockybase)
"bx" = (
/obj/structure/table,
/obj/item/paper{
	info = "We've finally been able to get the Vicerator delivery grenades working, Took awhile to make sure the latching mechanism didn't fail but we're sure we've got it this time. Vel'Shem's worried about the miners having there own drone fab now but I say it's a small price to pay to keep the metal flowing, Especially since there telling us NT's starting to monopolize the metal rich parts.";
	name = "V-Grenade Notice 1"
	},
/turf/floor/tiled/techfloor/virgo2,
/area/submap/virgo2/Rockybase)
"by" = (
/obj/machinery/door/airlock/engineering,
/turf/floor/tiled,
/area/submap/virgo2/Rockybase)
"bz" = (
/turf/floor/natural/barren,
/area/template_noop)
"bA" = (
/obj/structure/table,
/obj/item/stack/material/gemstone/mapped/diamond,
/obj/item/stack/material/gemstone/mapped/diamond,
/obj/item/stack/material/gemstone/mapped/diamond,
/obj/item/stack/material/gemstone/mapped/diamond,
/obj/item/stack/material/gemstone/mapped/diamond,
/obj/item/stack/material/gemstone/mapped/diamond,
/obj/item/stack/material/gemstone/mapped/diamond,
/obj/item/stack/material/gemstone/mapped/diamond,
/turf/floor/tiled/techfloor/virgo2,
/area/submap/virgo2/Rockybase)
"bB" = (
/obj/structure/table,
/obj/item/grenade/spawnergrenade/manhacks,
/turf/floor/tiled/techfloor/virgo2,
/area/submap/virgo2/Rockybase)
"bC" = (
/obj/structure/table,
/obj/item/stack/material/sheet/mapped/steel,
/turf/floor/tiled/techfloor/virgo2,
/area/submap/virgo2/Rockybase)
"bD" = (
/obj/structure/table,
/obj/machinery/light{
	dir = 1
	},
/obj/item/stock_parts/circuitboard/mecha/gygax/main,
/obj/item/stock_parts/circuitboard/mecha/gygax/peripherals,
/obj/item/stock_parts/circuitboard/mecha/gygax/targeting,
/turf/floor/tiled/techfloor/virgo2,
/area/submap/virgo2/Rockybase)
"bE" = (
/obj/item/shard,
/turf/floor/plating/virgo2,
/area/submap/virgo2/Rockybase)
"bF" = (
/obj/structure/table,
/obj/item/stack/material/aerogel/mapped/tritium/fifty,
/turf/floor/tiled/techfloor/virgo2,
/area/submap/virgo2/Rockybase)
"bG" = (
/obj/machinery/vending/engivend,
/turf/floor/plating/virgo2,
/area/submap/virgo2/Rockybase)
"bH" = (
/obj/machinery/vending/tool,
/turf/floor/plating/virgo2,
/area/submap/virgo2/Rockybase)
"bI" = (
/obj/structure/table,
/obj/item/toolbox,
/turf/floor/plating/virgo2,
/area/submap/virgo2/Rockybase)
"bJ" = (
/obj/structure/table,
/obj/item/toolbox/mechanical,
/turf/floor/plating/virgo2,
/area/submap/virgo2/Rockybase)
"bK" = (
/obj/item/mecha_parts/part/gygax_torso,
/turf/floor/tiled/techfloor/virgo2,
/area/submap/virgo2/Rockybase)
"bL" = (
/obj/machinery/light{
	dir = 1
	},
/obj/structure/closet/crate/medical,
/turf/floor/tiled/techfloor/virgo2,
/area/submap/virgo2/Rockybase)
"bM" = (
/obj/structure/table,
/obj/effect/decal/cleanable/dirt,
/obj/item/chems/hypospray/autoinjector/biginjector/burn,
/turf/floor/tiled/techfloor/virgo2,
/area/submap/virgo2/Rockybase)
"bN" = (
/obj/structure/table,
/obj/item/clothing/mask/breath/medical,
/obj/effect/decal/cleanable/dirt,
/turf/floor/tiled/techfloor/virgo2,
/area/submap/virgo2/Rockybase)
"bO" = (
/obj/effect/decal/cleanable/dirt,
/turf/floor/tiled/techfloor/virgo2,
/area/submap/virgo2/Rockybase)
"bP" = (
/obj/structure/closet/secure_closet/anesthetics,
/turf/floor/tiled/techfloor/virgo2,
/area/submap/virgo2/Rockybase)
"bQ" = (
/obj/structure/hygiene/toilet{
	dir = 4
	},
/obj/machinery/light/small{
	dir = 8
	},
/turf/floor/tiled/techfloor/virgo2,
/area/submap/virgo2/Rockybase)
"bR" = (
/obj/structure/table,
/obj/item/organ/internal/brain/robotic,
/turf/floor/tiled/techfloor/virgo2,
/area/submap/virgo2/Rockybase)
"bS" = (
/obj/item/stack/material/rods,
/obj/effect/decal/cleanable/dirt,
/obj/effect/decal/cleanable/dirt,
/turf/floor/tiled/techfloor/virgo2,
/area/submap/virgo2/Rockybase)
"bT" = (
/obj/effect/decal/cleanable/dirt,
/obj/structure/girder,
/turf/floor/plating/virgo2,
/area/submap/virgo2/Rockybase)
"bU" = (
/obj/effect/decal/cleanable/dirt,
/turf/floor/plating/virgo2,
/area/submap/virgo2/Rockybase)
"bV" = (
/obj/effect/decal/cleanable/dirt,
/obj/structure/table/frame,
/turf/floor/plating/virgo2,
/area/submap/virgo2/Rockybase)
"bW" = (
/obj/structure/girder,
/turf/floor/plating/virgo2,
/area/submap/virgo2/Rockybase)
"bX" = (
/obj/structure/closet/secure_closet/medical1,
/turf/floor/tiled/techfloor/virgo2,
/area/submap/virgo2/Rockybase)
"bY" = (
/obj/machinery/light/small{
	dir = 4;
	pixel_y = 0
	},
/turf/floor/tiled/techfloor/virgo2,
/area/submap/virgo2/Rockybase)
"bZ" = (
/obj/machinery/drone_fabricator{
	fabricator_tag = "Unknown Location"
	},
/turf/floor/tiled/techfloor/virgo2,
/area/submap/virgo2/Rockybase)
"ca" = (
/obj/machinery/fabricator/industrial,
/turf/floor/tiled/techfloor/virgo2,
/area/submap/virgo2/Rockybase)
"cb" = (
/obj/machinery/fabricator/robotics,
/turf/floor/tiled/techfloor/virgo2,
/area/submap/virgo2/Rockybase)
"cc" = (
/obj/structure/table,
/obj/item/mecha_parts/mecha_equipment/repair_droid,
/turf/floor/tiled/techfloor/virgo2,
/area/submap/virgo2/Rockybase)
"cd" = (
/obj/structure/cable{
	icon_state = "2-4"
	},
/turf/floor/plating/virgo2,
/area/submap/virgo2/Rockybase)
"ce" = (
/obj/structure/cable{
	icon_state = "4-8";
	pixel_x = 0
	},
/turf/floor/plating/virgo2,
/area/submap/virgo2/Rockybase)
"cf" = (
/obj/structure/cable{
	icon_state = "0-8"
	},
/obj/machinery/power/smes/buildable/preset/hidden,
/turf/floor/plating/virgo2,
/area/submap/virgo2/Rockybase)
"cg" = (
/obj/machinery/vending/medical,
/turf/floor/tiled/techfloor/virgo2,
/area/submap/virgo2/Rockybase)
"ch" = (
/obj/effect/decal/cleanable/dirt,
/obj/effect/decal/cleanable/dirt,
/turf/floor/tiled/techfloor/virgo2,
/area/submap/virgo2/Rockybase)
"ci" = (
/obj/effect/decal/cleanable/dirt,
/obj/effect/decal/cleanable/dirt,
/turf/floor/plating/virgo2,
/area/submap/virgo2/Rockybase)
"cj" = (
/obj/effect/decal/cleanable/dirt,
/obj/effect/decal/cleanable/dirt,
/obj/item/shard,
/turf/floor/plating/virgo2,
/area/submap/virgo2/Rockybase)
"ck" = (
/obj/effect/decal/cleanable/dirt,
/obj/effect/decal/cleanable/dirt,
/obj/effect/decal/cleanable/dirt,
/turf/floor/plating/virgo2,
/area/submap/virgo2/Rockybase)
"cl" = (
/obj/item/mecha_parts/part/gygax_armour,
/turf/floor/plating/virgo2,
/area/submap/virgo2/Rockybase)
"cm" = (
/obj/machinery/light{
	dir = 8
	},
/turf/floor/tiled/techfloor/virgo2,
/area/submap/virgo2/Rockybase)
"cn" = (
/obj/item/mecha_parts/chassis/gygax,
/turf/floor/tiled/techfloor/virgo2,
/area/submap/virgo2/Rockybase)
"co" = (
/mob/living/simple_mob/mechanical/mecha/combat/gygax/dark/advanced{
	faction = "syndicate"
	},
/turf/floor/tiled/techfloor/virgo2,
/area/submap/virgo2/Rockybase)
"cp" = (
/obj/machinery/vending/robotics,
/obj/machinery/light{
	icon_state = "tube1";
	dir = 4
	},
/turf/floor/tiled/techfloor/virgo2,
/area/submap/virgo2/Rockybase)
"cq" = (
/obj/structure/cable{
	icon_state = "0-4"
	},
/obj/machinery/light{
	dir = 8
	},
/obj/machinery/power/apc/super,
/turf/floor/plating/virgo2,
/area/submap/virgo2/Rockybase)
"cr" = (
/obj/structure/cable{
	icon_state = "4-8";
	pixel_x = 0
	},
/obj/structure/cable{
	icon_state = "2-8"
	},
/obj/structure/cable{
	icon_state = "1-8"
	},
/turf/floor/plating/virgo2,
/area/submap/virgo2/Rockybase)
"cs" = (
/obj/machinery/light{
	icon_state = "tube1";
	dir = 4
	},
/obj/structure/cable{
	icon_state = "0-8"
	},
/obj/machinery/power/smes/buildable/preset/hidden,
/turf/floor/plating/virgo2,
/area/submap/virgo2/Rockybase)
"ct" = (
/obj/effect/decal/cleanable/dirt,
/obj/effect/decal/cleanable/dirt,
/obj/effect/decal/cleanable/dirt,
/obj/effect/decal/cleanable/blood,
/turf/floor/plating/virgo2,
/area/submap/virgo2/Rockybase)
"cu" = (
/obj/item/mecha_parts/part/gygax_right_leg,
/turf/floor/tiled/techfloor/virgo2,
/area/submap/virgo2/Rockybase)
"cv" = (
/obj/structure/hygiene/sink{
	dir = 4;
	icon_state = "sink";
	pixel_x = 11;
	pixel_y = 0
	},
/obj/item/mecha_parts/part/gygax_left_arm,
/turf/floor/tiled/techfloor/virgo2,
/area/submap/virgo2/Rockybase)
"cw" = (
/obj/machinery/vending,
/turf/floor/tiled/techfloor/virgo2,
/area/submap/virgo2/Rockybase)
"cx" = (
/obj/structure/cable{
	icon_state = "1-4"
	},
/turf/floor/plating/virgo2,
/area/submap/virgo2/Rockybase)
"cy" = (
/obj/machinery/light{
	dir = 8
	},
/obj/structure/closet/secure_closet/medical3,
/turf/floor/tiled/techfloor/virgo2,
/area/submap/virgo2/Rockybase)
"cA" = (
/obj/structure/closet/secure_closet/hydroponics,
/turf/floor/tiled/techfloor/virgo2,
/area/submap/virgo2/Rockybase)
"cB" = (
/obj/machinery/mech_recharger,
/turf/floor/tiled/techfloor/virgo2,
/area/submap/virgo2/Rockybase)
"cC" = (
/obj/machinery/vending/tool,
/turf/floor/tiled/techfloor/virgo2,
/area/submap/virgo2/Rockybase)
"cD" = (
/obj/structure/table,
/obj/item/stack/material/sheet/reinforced/mapped/plasteel,
/obj/item/stack/material/pane/mapped/rglass,
/turf/floor/plating/virgo2,
/area/submap/virgo2/Rockybase)
"cE" = (
/obj/structure/table,
/obj/item/stack/material/pane/mapped/glass,
/obj/item/stack/material/sheet/mapped/steel,
/turf/floor/plating/virgo2,
/area/submap/virgo2/Rockybase)
"cF" = (
/obj/structure/table,
/obj/item/mecha_parts/part/gygax_head,
/turf/floor/plating/virgo2,
/area/submap/virgo2/Rockybase)
"cG" = (
/obj/structure/closet/toolcloset,
/turf/floor/plating/virgo2,
/area/submap/virgo2/Rockybase)
"cH" = (
/obj/structure/closet/secure_closet/medical3,
/turf/floor/tiled/techfloor/virgo2,
/area/submap/virgo2/Rockybase)
"cI" = (
/obj/item/surgicaldrill,
/obj/effect/decal/cleanable/dirt,
/turf/floor/tiled/techfloor/virgo2,
/area/submap/virgo2/Rockybase)
"cJ" = (
/obj/structure/loot_pile/maint/technical,
/turf/floor/tiled/techfloor/virgo2,
/area/submap/virgo2/Rockybase)
"cK" = (
/obj/item/clothing/suit/space/void/medical,
/obj/effect/decal/cleanable/dirt,
/turf/floor/tiled/techfloor/virgo2,
/area/submap/virgo2/Rockybase)
"cL" = (
/obj/effect/decal/cleanable/dirt,
/mob/living/bot/medbot,
/turf/floor/tiled/techfloor/virgo2,
/area/submap/virgo2/Rockybase)
"cM" = (
/obj/machinery/vending/hydroseeds,
/turf/floor/tiled/techfloor/virgo2,
/area/submap/virgo2/Rockybase)
"cN" = (
/obj/structure/closet/crate/secure/hydrosec,
/turf/floor/tiled/techfloor/virgo2,
/area/submap/virgo2/Rockybase)
"cO" = (
/turf/floor/natural/barren,
/area/submap/virgo2/Rockybase)
"cT" = (
/obj/item/remains,
/turf/floor/natural/barren,
/area/template_noop)

(1,1,1) = {"
aa
bz
bz
bz
bz
bz
bz
bz
bz
bz
bz
bz
bz
bz
bz
bz
bz
bz
bz
bz
bz
ab
ab
ab
ab
ab
ab
ab
bz
aa
"}
(2,1,1) = {"
bz
ac
cO
cO
cO
cO
cO
cO
ad
ad
ad
ag
ag
ag
ag
ag
cO
cO
cO
cO
cO
cO
cO
cO
cO
cO
cO
cO
cO
bz
"}
(3,1,1) = {"
bz
cO
cO
cO
cO
ad
ad
ag
ag
ag
ag
ag
ag
ag
ag
ag
ag
ag
ag
ag
ag
ag
ag
ag
ag
ag
ag
cO
cO
cT
"}
(4,1,1) = {"
bz
cO
cO
cO
cO
ag
ag
ag
ag
ag
al
al
al
al
al
al
al
al
al
al
al
al
al
al
ag
ag
ag
ag
cO
bz
"}
(5,1,1) = {"
bz
cO
cO
cO
cO
ag
ag
ag
ag
al
al
al
al
al
al
al
al
al
al
al
al
al
al
al
al
ag
ag
ag
cO
ab
"}
(6,1,1) = {"
bz
cO
cO
cO
cO
ag
ag
ag
ag
al
ak
aJ
aJ
ao
al
aN
al
aN
al
bQ
al
bQ
al
bQ
al
ag
ag
ag
cO
ab
"}
(7,1,1) = {"
bz
cO
cO
cO
cO
ag
ag
ag
ag
al
ao
ao
ao
ao
be
ao
be
ao
al
be
al
be
al
be
al
ag
ag
ag
cO
ab
"}
(8,1,1) = {"
bz
cO
cO
cO
cO
ag
ag
ag
ag
al
ap
aK
aT
ao
al
ao
al
ao
ao
aS
bY
ao
cv
ao
al
ag
ag
ag
cO
bz
"}
(9,1,1) = {"
bz
cO
cO
cO
cO
ad
ag
ag
ag
al
al
al
al
al
al
ao
al
al
al
al
al
al
al
al
al
ag
ag
ag
cO
bz
"}
(10,1,1) = {"
bz
cO
cO
cO
cO
ad
ad
ag
ag
al
aq
ao
ao
al
bi
ao
bo
al
aB
ao
ao
cm
ao
ao
al
ag
ag
ag
ag
bz
"}
(11,1,1) = {"
bz
cO
cO
cO
cO
cO
ad
ag
ag
al
aq
ao
aU
al
ao
ao
ao
al
bu
ao
bZ
ao
bZ
ao
al
ag
ag
ag
ag
bz
"}
(12,1,1) = {"
ab
cO
cO
cO
af
cO
ad
ag
ag
al
ar
ao
ao
be
ao
ao
ao
al
bv
ao
ao
ao
ao
ao
al
ag
ag
ag
ag
bz
"}
(13,1,1) = {"
ab
cO
cO
cO
cO
cO
ad
ag
ag
al
as
ao
ao
al
ao
bl
aV
al
bw
ao
ao
cn
ao
ao
al
ag
ag
ag
ag
bz
"}
(14,1,1) = {"
ab
cO
ad
cO
cO
cO
ag
ag
ag
al
ao
ao
aV
al
ao
ao
ao
al
bx
ao
bZ
ao
bq
ao
al
ag
ag
ag
ag
bz
"}
(15,1,1) = {"
ab
cO
ad
cO
cO
cO
ag
ag
ag
al
ao
ao
ao
al
aE
ao
ao
al
bA
ao
ao
co
bq
ao
al
ag
ag
ag
cO
bz
"}
(16,1,1) = {"
ab
cO
ad
cO
cO
cO
ag
ag
ag
al
aq
ao
aq
al
ao
ao
ao
al
bB
ao
ao
ao
ao
aV
al
ag
ag
af
cO
bz
"}
(17,1,1) = {"
bz
cO
ad
cO
cO
cO
ag
ag
ag
al
at
ao
aW
al
ao
bm
ao
al
bC
ao
ca
ao
ao
cB
al
ag
ag
cO
cO
bz
"}
(18,1,1) = {"
bz
ad
ad
cO
cO
cO
ag
ag
ag
al
au
ao
aq
al
ao
bn
ao
al
bD
ao
ao
ao
ao
ao
al
ag
ag
cO
cO
bz
"}
(19,1,1) = {"
bz
cO
cO
cO
cO
cO
ad
ag
ag
al
at
ao
at
al
ao
ao
bp
al
bj
ao
cb
ao
ao
cB
al
ag
ag
cO
cO
bz
"}
(20,1,1) = {"
bz
cO
cO
cO
cO
cO
ad
ad
ag
al
aq
ao
aq
al
bj
ao
ao
bq
bq
ao
ao
ao
ao
ao
al
ag
ag
ag
cO
bz
"}
(21,1,1) = {"
aa
cO
cO
cO
cO
cO
cO
cO
ag
al
av
ao
at
al
ao
ao
bq
bq
bE
bq
bq
ao
ao
ao
al
ag
ag
ag
cO
bz
"}
(22,1,1) = {"
bz
ad
ad
ad
ad
cO
cO
cO
ag
al
al
al
al
al
aE
ao
bn
al
bF
bR
cc
cp
cw
cC
al
ag
ag
ag
cO
aa
"}
(23,1,1) = {"
bz
cO
cO
cO
cO
cO
cO
bq
ag
al
al
al
al
al
ao
ao
aV
al
al
al
al
al
al
al
al
ag
ag
ag
cO
bz
"}
(24,1,1) = {"
bz
cO
cO
cO
cO
cO
bq
bq
bq
al
aw
aL
aX
al
ao
ao
ao
al
bG
bq
bq
cq
bq
cD
al
ag
ag
ag
cO
bz
"}
(25,1,1) = {"
an
bq
bq
bq
bq
bq
bq
ah
bq
al
ax
ao
ao
be
ao
ao
bm
al
bH
bq
bq
ce
bq
cE
al
ag
ag
ag
cO
bz
"}
(26,1,1) = {"
an
bq
bq
bq
bq
bq
bq
bq
aj
al
ay
ao
aY
al
ao
ao
ao
by
bq
bq
cd
cr
cx
cF
al
ag
ag
cO
cO
ab
"}
(27,1,1) = {"
an
bq
bq
bq
bq
bq
bq
bq
bq
al
az
aM
aZ
al
ao
ao
br
al
bI
bq
ce
ce
ce
cG
al
ag
ag
cO
cO
ab
"}
(28,1,1) = {"
an
bq
bq
bq
bq
bq
bq
ai
bq
am
al
al
al
al
ao
ao
ao
al
bJ
bq
cf
cs
cf
bq
al
ag
ag
cO
cO
ab
"}
(29,1,1) = {"
an
bq
bq
bq
bq
bq
bq
bq
bq
ae
ao
aN
ao
ae
ao
ao
ao
al
al
al
al
al
al
al
al
ag
ag
cO
cO
ab
"}
(30,1,1) = {"
an
bq
bq
bq
bq
bq
bq
bq
bq
ae
ao
ao
ao
ae
ao
ao
ao
al
bK
bj
cg
ao
cy
cH
al
ag
ag
cO
ad
ab
"}
(31,1,1) = {"
an
bq
bq
bq
bq
bq
bq
bq
bq
am
al
al
al
al
ao
ao
ao
ao
ao
ao
ao
ao
ao
ao
al
ag
ag
cO
ad
ab
"}
(32,1,1) = {"
an
bq
bq
bq
bq
bq
bq
bq
ai
al
aA
aO
ba
al
ao
ao
ao
al
ao
bO
bO
bO
ao
cI
al
ag
cO
cO
ad
ab
"}
(33,1,1) = {"
an
bq
bq
bq
bq
bq
bq
bq
aj
al
aB
aP
bb
al
aE
ao
ao
al
bL
bO
ch
ct
ch
ao
al
ag
ag
cO
ad
ab
"}
(34,1,1) = {"
an
bq
bq
bq
bq
bq
bq
ah
bq
al
aC
ao
ao
al
ao
ao
ao
al
bM
bS
ci
ck
ci
ao
al
ag
ag
cO
ad
ab
"}
(35,1,1) = {"
bz
cO
cO
cO
cO
cO
bq
bq
bq
al
aD
ao
ao
al
ao
ao
aV
al
bN
bT
cj
ck
bU
cJ
al
ag
ag
cO
ad
ab
"}
(36,1,1) = {"
bz
cO
cO
cO
cO
cO
cO
bq
ag
al
aE
ao
ao
bk
ao
ao
ao
al
bO
bU
ck
ci
bU
bW
al
ag
cO
cO
ad
ab
"}
(37,1,1) = {"
ab
ad
ad
cO
cO
cO
cO
cO
ag
al
aF
aQ
ao
al
ao
ao
ao
al
ao
bV
ci
bV
bU
cJ
al
ag
cO
cO
ad
ab
"}
(38,1,1) = {"
ab
ad
ad
cO
cO
cO
cO
cO
ag
al
al
al
bg
al
ao
bl
ao
al
ao
bW
cl
bq
bU
cK
al
ag
cO
cO
ad
ab
"}
(39,1,1) = {"
ab
ad
ad
cO
cO
cO
ad
ad
ag
al
ao
ao
aV
al
aE
ao
ao
al
ao
ao
bq
bE
bq
bO
al
ag
ag
cO
ad
ab
"}
(40,1,1) = {"
ab
ad
ad
cO
cO
cO
ad
ag
ag
al
bc
aR
bc
al
ao
ao
bs
al
bP
bX
ao
ao
bO
cL
al
ag
ag
cO
ad
ab
"}
(41,1,1) = {"
ab
ad
ad
cO
cO
cO
ad
ag
ag
al
al
al
al
al
al
bk
al
al
al
al
al
al
al
al
al
ag
ag
cO
ad
ab
"}
(42,1,1) = {"
ab
cO
cO
cO
cO
cO
ag
ag
ag
al
aH
ao
ao
bf
ao
ao
ao
ao
ao
ao
ao
ao
ao
cM
al
ag
ag
cO
ad
ab
"}
(43,1,1) = {"
ab
cO
cO
cO
cO
cO
ag
ag
ag
al
aI
aS
bd
bh
bd
bd
bh
bd
bd
bh
bd
cu
cA
cN
al
ag
ag
cO
ad
ab
"}
(44,1,1) = {"
ab
ac
cO
cO
cO
cO
ag
ag
ag
al
al
al
al
al
al
al
al
al
al
al
al
al
al
al
al
ag
ag
cO
ad
ab
"}
(45,1,1) = {"
bz
cO
cO
af
cO
cO
cO
ag
ag
ag
al
al
al
al
al
al
al
al
al
al
al
al
al
al
ag
ag
ag
cO
ad
ab
"}
(46,1,1) = {"
bz
cO
cO
cO
cO
cO
cO
ag
ag
ag
ag
ag
ag
ag
ag
ag
ag
ag
ag
ag
ag
ag
ag
ag
ag
ag
cO
cO
cO
cT
"}
(47,1,1) = {"
bz
cO
cO
cO
cO
cO
cO
ag
ag
ag
ag
ag
ag
ag
ag
ag
ag
ag
ag
ag
ag
ag
cO
ag
cO
cO
cO
cO
cO
bz
"}
(48,1,1) = {"
bz
cO
cO
cO
cO
cO
cO
ag
ag
ag
ag
ag
ag
ag
ag
ag
ag
ag
ag
ag
cO
cO
cO
cO
cO
cO
cO
cO
cO
bz
"}
(49,1,1) = {"
bz
cO
cO
ad
ad
ad
cO
cO
cO
cO
cO
cO
cO
cO
cO
cO
cO
cO
cO
cO
cO
cO
cO
cO
af
cO
cO
ad
ad
ab
"}
(50,1,1) = {"
aa
bz
bz
ab
ab
ab
ab
bz
bz
bz
bz
bz
bz
bz
ab
ab
ab
ab
ab
ab
ab
ab
ab
ab
ab
ab
ab
ab
ab
ab
"}
