//MAP CONVERTED BY dmm2tgm.py THIS HEADER COMMENT PREVENTS RECONVERSION, DO NOT REMOVE
"aa" = (
/turf/template_noop,
/area/mine/explored/underdark)
"ab" = (
/turf/wall,
/area/mine/explored/underdark)
"ac" = (
/turf/template_noop,
/area/space)
"ad" = (
/turf/exterior/barren,
/area/mine/explored/underdark)
"ae" = (
/turf/floor/tiled/steel_dirty/virgo3b,
/area/mine/explored/underdark)
"af" = (
/obj/machinery/door/airlock/uranium,
/turf/floor/tiled/steel_dirty/virgo3b,
/area/mine/explored/underdark)
"ag" = (
/obj/machinery/door/airlock/double/glass{
	dir = 1
	},
/turf/floor/tiled/steel_dirty/virgo3b,
/area/mine/explored/underdark)
"ah" = (
/obj/machinery/floodlight,
/turf/exterior/barren,
/area/mine/explored/underdark)
"aj" = (
/obj/structure/crystal,
/turf/exterior/barren,
/area/mine/explored/underdark)
"ak" = (
/obj/machinery/light/flicker,
/turf/exterior/barren,
/area/mine/explored/underdark)
"al" = (
/obj/machinery/mech_recharger,
/turf/floor/tiled/steel_dirty/virgo3b,
/area/mine/explored/underdark)
"am" = (
/obj/machinery/gravity_generator,
/turf/exterior/barren,
/area/mine/explored/underdark)
"an" = (
/obj/machinery/implantchair,
/turf/floor/tiled/steel_dirty/virgo3b,
/area/mine/explored/underdark)
"aq" = (
/obj/machinery/particle_accelerator/control_box,
/turf/floor/tiled/steel_dirty/virgo3b,
/area/mine/explored/underdark)
"ar" = (
/obj/structure/old_roboprinter,
/turf/floor/tiled/steel_dirty/virgo3b,
/area/mine/explored/underdark)
"as" = (
/obj/tether_away_spawner/underdark_drone_swarm,
/turf/floor/tiled/steel_dirty/virgo3b,
/area/mine/explored/underdark)
"at" = (
/obj/tether_away_spawner/underdark_hard,
/turf/exterior/barren,
/area/mine/explored/underdark)
"au" = (
/obj/tether_away_spawner/underdark_normal,
/turf/floor/tiled/steel_dirty/virgo3b,
/area/mine/explored/underdark)
"av" = (
/obj/structure/ore_box,
/turf/floor/tiled/steel_dirty/virgo3b,
/area/mine/explored/underdark)
"aw" = (
/obj/structure/dogbed,
/turf/floor/tiled/steel_dirty/virgo3b,
/area/mine/explored/underdark)
"ax" = (
/obj/structure/cult/forge,
/turf/floor/tiled/steel_dirty/virgo3b,
/area/mine/explored/underdark)
"ay" = (
/obj/structure/cult/tome,
/turf/floor/tiled/steel_dirty/virgo3b,
/area/mine/explored/underdark)
"az" = (
/obj/structure/bed,
/turf/floor/tiled/steel_dirty/virgo3b,
/area/mine/explored/underdark)
"aA" = (
/obj/structure/barricade,
/turf/exterior/barren,
/area/mine/explored/underdark)
"aB" = (
/obj/structure/barricade,
/obj/structure/boulder,
/turf/exterior/barren,
/area/mine/explored/underdark)
"aC" = (
/obj/structure/table/steel,
/turf/floor/tiled/steel_dirty/virgo3b,
/area/mine/explored/underdark)
"aD" = (
/obj/structure/hygiene/sink,
/turf/floor/tiled/steel_dirty/virgo3b,
/area/mine/explored/underdark)
"aE" = (
/obj/structure/sign/ironhammer,
/turf/wall,
/area/mine/explored/underdark)
"aF" = (
/obj/structure/iv_drip,
/obj/effect/decal/cleanable/cobweb2,
/turf/floor/tiled/steel_dirty/virgo3b,
/area/mine/explored/underdark)
"aG" = (
/obj/structure/table/steel,
/obj/machinery/reagentgrinder,
/turf/floor/tiled/steel_dirty/virgo3b,
/area/mine/explored/underdark)
"aH" = (
/obj/machinery/smartfridge,
/turf/floor/tiled/steel_dirty/virgo3b,
/area/mine/explored/underdark)
"aI" = (
/obj/structure/filing_cabinet,
/turf/floor/tiled/steel_dirty/virgo3b,
/area/mine/explored/underdark)
"aJ" = (
/obj/machinery/vending/cola,
/turf/floor/tiled/steel_dirty/virgo3b,
/area/mine/explored/underdark)
"aK" = (
/obj/machinery/vending/coffee,
/turf/floor/tiled/steel_dirty/virgo3b,
/area/mine/explored/underdark)
"aL" = (
/obj/machinery/vending/fitness,
/turf/floor/tiled/steel_dirty/virgo3b,
/area/mine/explored/underdark)
"aM" = (
/obj/machinery/replicator,
/turf/floor/tiled/steel_dirty/virgo3b,
/area/mine/explored/underdark)
"aN" = (
/obj/machinery/vending/snack,
/turf/floor/tiled/steel_dirty/virgo3b,
/area/mine/explored/underdark)
"aO" = (
/obj/machinery/porta_turret/stationary/syndie{
	faction = "underdark"
	},
/turf/floor/tiled/steel_dirty/virgo3b,
/area/mine/explored/underdark)
"aP" = (
/obj/structure/table/steel,
/obj/machinery/recharger,
/turf/floor/tiled/steel_dirty/virgo3b,
/area/mine/explored/underdark)
"aQ" = (
/obj/machinery/recharger/wallcharger,
/turf/wall,
/area/mine/explored/underdark)
"aR" = (
/obj/item/frame/apc,
/turf/floor/tiled/steel_dirty/virgo3b,
/area/mine/explored/underdark)
"aS" = (
/obj/structure/table/steel,
/obj/machinery/light/fixture{
	icon_state = "tube-construct-stage1";
	dir = 1
	},
/turf/floor/tiled/steel_dirty/virgo3b,
/area/mine/explored/underdark)
"aT" = (
/obj/machinery/light/fixture{
	icon_state = "tube-construct-stage1";
	dir = 1
	},
/turf/floor/tiled/steel_dirty/virgo3b,
/area/mine/explored/underdark)
"aU" = (
/obj/machinery/light/fixture{
	icon_state = "tube-construct-stage1";
	dir = 8
	},
/turf/floor/tiled/steel_dirty/virgo3b,
/area/mine/explored/underdark)
"aV" = (
/obj/machinery/light/fixture{
	icon_state = "tube-construct-stage1";
	dir = 4
	},
/turf/floor/tiled/steel_dirty/virgo3b,
/area/mine/explored/underdark)
"aW" = (
/obj/machinery/light/fixture,
/turf/floor/tiled/steel_dirty/virgo3b,
/area/mine/explored/underdark)
"aX" = (
/obj/machinery/light/flamp/flicker,
/turf/exterior/barren,
/area/mine/explored/underdark)
"aY" = (
/obj/effect/decal/cleanable/cobweb,
/turf/floor/tiled/steel_dirty/virgo3b,
/area/mine/explored/underdark)
"aZ" = (
/obj/machinery/transhuman_clonepod,
/turf/floor/tiled/steel_dirty/virgo3b,
/area/mine/explored/underdark)
"bc" = (
/obj/item/remains/deer,
/turf/exterior/barren,
/area/mine/explored/underdark)
"bd" = (
/obj/effect/decal/cleanable/blood/drip,
/turf/exterior/barren,
/area/mine/explored/underdark)
"be" = (
/obj/item/remains/deer,
/obj/effect/decal/cleanable/blood,
/turf/exterior/barren,
/area/mine/explored/underdark)
"bf" = (
/obj/effect/decal/cleanable/blood/drip,
/obj/effect/decal/cleanable/blood/drip,
/turf/exterior/barren,
/area/mine/explored/underdark)
"bg" = (
/obj/machinery/door/airlock/uranium,
/obj/effect/decal/cleanable/blood/drip,
/obj/effect/decal/cleanable/dirt,
/turf/floor/tiled/steel_dirty/virgo3b,
/area/mine/explored/underdark)
"bh" = (
/obj/effect/decal/cleanable/blood/drip,
/obj/effect/decal/cleanable/dirt,
/turf/floor/tiled/steel_dirty/virgo3b,
/area/mine/explored/underdark)
"bi" = (
/obj/item/remains/human,
/obj/effect/decal/cleanable/blood,
/turf/floor/tiled/steel_dirty/virgo3b,
/area/mine/explored/underdark)
"bj" = (
/obj/effect/decal/cleanable/dirt,
/turf/floor/tiled/steel_dirty/virgo3b,
/area/mine/explored/underdark)
"bk" = (
/obj/machinery/light/fixture,
/obj/item/remains/human,
/obj/effect/decal/cleanable/blood,
/turf/floor/tiled/steel_dirty/virgo3b,
/area/mine/explored/underdark)
"bl" = (
/obj/effect/decal/cleanable/cobweb2,
/turf/floor/tiled/steel_dirty/virgo3b,
/area/mine/explored/underdark)
"bm" = (
/obj/structure/table/steel,
/obj/machinery/microwave,
/obj/effect/decal/cleanable/cobweb,
/turf/floor/tiled/steel_dirty/virgo3b,
/area/mine/explored/underdark)
"bn" = (
/obj/structure/table/steel,
/obj/machinery/microwave,
/obj/effect/decal/cleanable/cobweb2,
/turf/floor/tiled/steel_dirty/virgo3b,
/area/mine/explored/underdark)
"bo" = (
/obj/structure/bed,
/obj/effect/decal/cleanable/cobweb2,
/turf/floor/tiled/steel_dirty/virgo3b,
/area/mine/explored/underdark)
"bp" = (
/obj/tether_away_spawner/underdark_normal,
/obj/effect/decal/cleanable/cobweb,
/turf/floor/tiled/steel_dirty/virgo3b,
/area/mine/explored/underdark)
"bq" = (
/obj/tether_away_spawner/underdark_normal,
/obj/effect/decal/cleanable/cobweb2,
/turf/floor/tiled/steel_dirty/virgo3b,
/area/mine/explored/underdark)
"br" = (
/obj/effect/decal/cleanable/vomit,
/turf/floor/tiled/steel_dirty/virgo3b,
/area/mine/explored/underdark)
"bs" = (
/obj/machinery/door/airlock/uranium,
/obj/effect/decal/cleanable/dirt,
/turf/floor/tiled/steel_dirty/virgo3b,
/area/mine/explored/underdark)
"bt" = (
/obj/item/remains/tajaran,
/obj/effect/decal/cleanable/blood,
/obj/effect/decal/cleanable/dirt,
/turf/floor/tiled/steel_dirty/virgo3b,
/area/mine/explored/underdark)
"bu" = (
/obj/effect/decal/cleanable/spiderling_remains,
/turf/exterior/barren,
/area/mine/explored/underdark)
"bv" = (
/obj/item/assembly/prox_sensor,
/turf/floor/tiled/steel_dirty/virgo3b,
/area/mine/explored/underdark)
"bw" = (
/obj/item/electronic_assembly/drone/genbot,
/turf/floor/tiled/steel_dirty/virgo3b,
/area/mine/explored/underdark)
"bx" = (
/obj/structure/table/steel,
/obj/item/assembly/electronic_assembly,
/obj/item/stock_parts/circuitboard/aicore,
/turf/floor/tiled/steel_dirty/virgo3b,
/area/mine/explored/underdark)
"by" = (
/obj/item/assembly/signaler,
/turf/floor/tiled/steel_dirty/virgo3b,
/area/mine/explored/underdark)
"bz" = (
/obj/machinery/door/airlock/uranium{
	hasShocked = 1
	},
/obj/effect/decal/cleanable/dirt,
/turf/floor/tiled/steel_dirty/virgo3b,
/area/mine/explored/underdark)
"bA" = (
/obj/machinery/door/airlock/uranium{
	hasShocked = 1
	},
/turf/floor/tiled/steel_dirty/virgo3b,
/area/mine/explored/underdark)
"bB" = (
/mob/living/simple_mob/mechanical/infectionbot{
	faction = "underdark"
	},
/turf/floor/tiled/steel_dirty/virgo3b,
/area/mine/explored/underdark)
"bC" = (
/obj/random/underdark,
/turf/floor/tiled/steel_dirty/virgo3b,
/area/mine/explored/underdark)
"bD" = (
/obj/effect/decal/cleanable/dirt,
/obj/random/underdark,
/turf/floor/tiled/steel_dirty/virgo3b,
/area/mine/explored/underdark)
"bE" = (
/obj/item/geiger,
/turf/exterior/barren,
/area/mine/explored/underdark)
"dN" = (
/obj/effect/decal/cleanable/dirt,
/obj/effect/decal/cleanable/blood,
/turf/floor/tiled/steel_dirty/virgo3b,
/area/mine/explored/underdark)
"kn" = (
/obj/tether_away_spawner/underdark_normal,
/turf/exterior/barren,
/area/mine/explored/underdark)
"ul" = (
/obj/tether_away_spawner/underdark_hard,
/turf/floor/tiled/steel_dirty/virgo3b,
/area/mine/explored/underdark)
"GV" = (
/obj/item/stack/material/ore/hydrogen,
/obj/structure/table/steel,
/turf/floor/tiled/steel_dirty/virgo3b,
/area/mine/explored/underdark)
"PX" = (
/obj/structure/bed,
/obj/random/gun/random,
/turf/floor/tiled/steel_dirty/virgo3b,
/area/mine/explored/underdark)
"Sz" = (
/obj/effect/decal/cleanable/blood,
/turf/floor/tiled/steel_dirty/virgo3b,
/area/mine/explored/underdark)

(1,1,1) = {"
aa
aa
aa
aa
aa
aa
ad
ad
ad
bc
ad
ad
ad
ad
ad
ad
ad
aj
ad
ad
ad
aj
ad
ac
"}
(2,1,1) = {"
aa
aa
aa
aa
aa
aa
ad
ad
ad
ad
ad
ad
aj
ad
ad
bE
ad
ad
ad
aj
ad
ad
ad
ac
"}
(3,1,1) = {"
aa
aa
aa
aa
aa
aa
ad
ab
ab
ab
ab
ab
ab
ab
ab
ab
ab
ab
ab
ab
ab
ab
ad
ac
"}
(4,1,1) = {"
aa
aa
aa
aa
aa
aa
ad
ab
aw
ae
aU
au
ab
al
aP
bx
aP
al
ab
bp
GV
ab
ad
ac
"}
(5,1,1) = {"
aj
ad
ad
ad
ah
ad
ad
af
ae
ae
ae
ae
ab
ae
ae
ae
by
ae
ab
ae
ae
ab
ad
ac
"}
(6,1,1) = {"
aj
ad
ad
ad
ad
ad
ad
ab
aF
ae
aZ
aM
ab
bv
ae
ae
ae
bC
ab
bi
ae
ab
ad
ac
"}
(7,1,1) = {"
ad
ad
aj
ad
ad
ad
ad
ab
ab
af
ab
ab
ab
aD
bB
ae
bB
ae
bA
br
ae
ab
ad
ac
"}
(8,1,1) = {"
ad
ad
ad
ad
ad
am
ad
ab
ae
ae
ae
av
ab
aT
ae
ae
ae
aI
ab
bj
dN
ab
ad
ac
"}
(9,1,1) = {"
aA
ad
aX
ad
ad
ad
ad
af
ae
ae
ae
ae
ab
bw
ae
ae
ae
bC
ab
bj
bj
ab
bc
ac
"}
(10,1,1) = {"
ad
ad
ad
at
ad
bc
ad
ab
av
ae
ae
aV
ab
ax
ae
bj
ae
ay
ab
bj
bD
ab
ad
ac
"}
(11,1,1) = {"
aA
ad
ad
ad
ad
ad
ak
ab
ab
ae
ag
ab
ab
ab
aQ
bz
ab
ab
ab
ae
bC
ab
ad
ac
"}
(12,1,1) = {"
aB
aA
aj
ad
ad
ad
aj
ab
aY
ae
ae
aN
ab
aR
aU
bj
ae
ae
aU
ae
aJ
ab
ad
ac
"}
(13,1,1) = {"
aA
aA
ad
ad
bd
bd
bf
bg
bh
bh
bh
bh
bg
bh
bj
bj
bt
ul
ae
ae
aK
ab
ad
ac
"}
(14,1,1) = {"
aA
aA
ad
ad
be
ad
bE
ab
bl
ae
ae
ae
ab
bi
ae
bj
ae
ae
ae
ae
aL
ab
bc
ac
"}
(15,1,1) = {"
aA
bu
ad
ad
ad
ad
ak
ab
ab
ae
ag
ab
ab
ab
aE
bs
aE
ab
ab
ae
bC
ab
ad
ac
"}
(16,1,1) = {"
ad
ad
aX
ad
ad
ad
ad
ab
bm
ae
ae
aG
ab
ar
ae
bj
ae
ar
ab
ae
bC
ab
ad
ac
"}
(17,1,1) = {"
aA
bu
ad
ad
kn
ad
ad
ab
aS
ae
Sz
aC
ab
ae
ae
ae
ae
ae
ab
ae
ae
ab
ad
ac
"}
(18,1,1) = {"
bu
ad
ad
aj
ad
aj
ad
ab
aC
au
ae
aC
ab
as
ae
ae
ae
as
aE
ae
ae
ab
ad
ac
"}
(19,1,1) = {"
ad
ad
ad
ad
ad
ad
ad
ab
bn
ae
ae
aH
ab
ae
ae
Sz
ae
ae
af
ae
bk
ab
ad
ac
"}
(20,1,1) = {"
aj
ad
ad
ad
ad
ad
ad
ab
ab
ab
af
ab
ab
aT
ae
ae
ae
aW
aE
ae
ae
ab
ad
ac
"}
(21,1,1) = {"
aj
ad
ad
ad
ad
ah
ad
ab
aT
au
ae
ae
ab
ae
ae
ae
ae
ae
ab
ae
ae
ab
ad
ac
"}
(22,1,1) = {"
aa
aa
aa
aa
aa
aa
aa
ab
bo
PX
az
an
ab
ae
ae
aO
ae
aq
ab
bq
ae
ab
ad
ac
"}
(23,1,1) = {"
aa
aa
aa
aa
aa
aa
aa
ab
ab
ab
ab
ab
ab
ab
ab
ab
ab
ab
ab
ab
ab
ab
ad
ac
"}
(24,1,1) = {"
aa
aa
aa
aa
aa
aa
aa
ad
ad
ad
ad
ad
ad
ad
ad
ad
ad
ad
ad
ad
aj
ad
ad
ac
"}
(25,1,1) = {"
aa
aa
aa
aa
aa
aa
aa
ad
bE
ad
ad
ad
ad
aj
ad
ad
ad
bc
ad
ad
ad
ad
ad
ac
"}
