//MAP CONVERTED BY dmm2tgm.py THIS HEADER COMMENT PREVENTS RECONVERSION, DO NOT REMOVE
"a" = (
/turf/wall/gold,
/area/mine/explored/underdark)
"b" = (
/turf/template_noop,
/area/mine/explored/underdark)
"c" = (
/obj/structure/window/basic/full,
/turf/floor/tiled/kafel_full/yellow/virgo3b,
/area/mine/explored/underdark)
"d" = (
/turf/floor/tiled/kafel_full/yellow/virgo3b,
/area/mine/explored/underdark)
"e" = (
/obj/item/chems/condiment/ketchup,
/turf/floor/tiled/kafel_full/yellow/virgo3b,
/area/mine/explored/underdark)
"f" = (
/obj/item/clothing/suit/storage/toggle/hoodie/blue,
/obj/item/clothing/shoes/slippers_worn,
/turf/floor/tiled/kafel_full/yellow/virgo3b,
/area/mine/explored/underdark)
"g" = (
/obj/item/remains,
/turf/floor/tiled/kafel_full/yellow/virgo3b,
/area/mine/explored/underdark)
"p" = (
/obj/structure/closet/crate,
/obj/random/gun/random,
/turf/floor/tiled/kafel_full/yellow/virgo3b,
/area/mine/explored/underdark)
"F" = (
/obj/tether_away_spawner/underdark_hard,
/turf/floor/tiled/kafel_full/yellow/virgo3b,
/area/mine/explored/underdark)
"H" = (
/obj/tether_away_spawner/underdark_normal,
/turf/floor/tiled/kafel_full/yellow/virgo3b,
/area/mine/explored/underdark)
"L" = (
/obj/structure/closet/crate/secure/loot,
/turf/floor/tiled/kafel_full/yellow/virgo3b,
/area/mine/explored/underdark)
"O" = (
/obj/tether_away_spawner/underdark_boss,
/turf/floor/tiled/kafel_full/yellow/virgo3b,
/area/mine/explored/underdark)
"P" = (
/obj/random/outcrop,
/turf/floor/tiled/kafel_full/yellow/virgo3b,
/area/mine/explored/underdark)
"U" = (
/obj/random/loot_pile/maintenance,
/turf/floor/tiled/kafel_full/yellow/virgo3b,
/area/mine/explored/underdark)

(1,1,1) = {"
a
b
a
b
b
b
b
b
b
b
"}
(2,1,1) = {"
a
b
b
b
b
b
b
d
b
b
"}
(3,1,1) = {"
b
b
b
b
b
b
d
d
P
b
"}
(4,1,1) = {"
b
b
b
b
d
d
d
d
d
b
"}
(5,1,1) = {"
a
b
d
d
d
F
d
L
d
a
"}
(6,1,1) = {"
a
b
a
d
d
d
d
a
d
a
"}
(7,1,1) = {"
a
P
U
d
d
d
b
b
d
a
"}
(8,1,1) = {"
c
d
d
d
O
d
b
b
b
b
"}
(9,1,1) = {"
c
d
d
d
d
f
d
b
b
b
"}
(10,1,1) = {"
a
P
H
d
e
g
d
d
p
a
"}
(11,1,1) = {"
a
b
a
d
d
d
d
a
d
a
"}
(12,1,1) = {"
a
b
d
d
H
d
d
d
d
a
"}
(13,1,1) = {"
b
b
b
d
d
d
d
d
H
b
"}
(14,1,1) = {"
b
b
b
b
b
b
d
d
d
b
"}
(15,1,1) = {"
a
b
b
b
b
b
b
P
b
b
"}
