//MAP CONVERTED BY dmm2tgm.py THIS HEADER COMMENT PREVENTS RECONVERSION, DO NOT REMOVE
"a" = (
/turf/template_noop,
/area/mine/explored/underdark)
"b" = (
/turf/floor/natural/barren,
/area/mine/explored/underdark)
"c" = (
/obj/random/multiple/underdark/mechtool,
/turf/floor/natural/barren,
/area/mine/explored/underdark)

(1,1,1) = {"
a
a
b
b
a
"}
(2,1,1) = {"
a
b
b
b
b
"}
(3,1,1) = {"
b
b
b
b
c
"}
(4,1,1) = {"
b
b
b
b
b
"}
(5,1,1) = {"
b
c
b
b
b
"}
(6,1,1) = {"
a
b
b
b
a
"}
